Seccion Nro,Seccion Nombre,Circuito Nro,Circuito Nombre,Escuela,Mesas,Desde,Hasta,Electores
1,CAPITAL,1,SECCIONAL PRIMERA,CENTRO EDUC.NIVEL MEDIO ADULTO - DEAN FUNES 417,7,1,7,2408
1,CAPITAL,1,SECCIONAL PRIMERA,ESC NUESTRA SEÑORA DEL HUERTO - BELGRANO 269,12,8,19,4119
1,CAPITAL,1,SECCIONAL PRIMERA,COL NAC DE MONSERRAT - OBISPO TREJO 294,17,20,36,5831
1,CAPITAL,1,SECCIONAL PRIMERA,ESC SANTA TERESA DE JESUS - OBISPO TREJO Y SANABRIA 160,10,37,46,3430
1,CAPITAL,2,SECCIONAL SEGUNDA,ESC JUAN BAUTISTA ALBERDI - GRAL PAZ 486,17,47,63,5693
1,CAPITAL,3,SECCIONAL TERCERA,ESC JERONIMO LUIS DE CABRERA - SANTA ROSA 650,14,64,77,4830
1,CAPITAL,3,SECCIONAL TERCERA,IPEM N° 270 GRAL M BELGRANO - DEAN FUNES 850,10,78,87,3450
1,CAPITAL,3,SECCIONAL TERCERA,ESC SANTO TOMAS - CASEROS 745,8,88,95,2756
1,CAPITAL,3,SECCIONAL TERCERA,ESC NORMAL ALEJANDRO CARBO - AV COLON 951,13,96,108,4472
1,CAPITAL,3,SECCIONAL TERCERA,ESC MARIANO MORENO - SANTA ROSA ESQ SANTA FE,13,109,121,4472
1,CAPITAL,4,NUEVA CORDOBA,ENET N° 3 LEOPOLDO LUGONES - ITUZAINGO 483,12,122,133,4128
1,CAPITAL,4,NUEVA CORDOBA,COL NACIONAL DEAN FUNES - PERU 10,20,134,153,6880
1,CAPITAL,4,NUEVA CORDOBA,ESC GDOR ALVAREZ - C ARENAL 699 B°R MARTINEZ,11,154,164,3784
1,CAPITAL,4,NUEVA CORDOBA,FAC DE CIENCIAS ECONOMICAS - AV VALPARAISO CDAD UNIVERSITARIA,16,165,180,5495
1,CAPITAL,4A,PUEBLO LAS FLORES,ESC ERNESTO BANCALARI - MONTERROSO 4597 B° ARTIGAS,7,181,187,2373
1,CAPITAL,4A,PUEBLO LAS FLORES,ESC ALMAFUERTE - CHANETON 390 B° SAN FERNANDO,7,188,194,2373
1,CAPITAL,4A,PUEBLO LAS FLORES,ESC COM R ECHEGOYEN - J I DIAZ 200 B° EJERCITO ARGENTINO,8,195,202,2708
1,CAPITAL,4A,PUEBLO LAS FLORES,ESC SAN FRANCISCO DE ASIS - GUARDADO 184 B°LAS FLORES,29,203,231,9802
1,CAPITAL,4B,VILLA REVOL,INST EDUC NTRA SEÑORA - INCA MANCO 3450 - B°JARDIN ESPINOSA,22,232,253,7464
1,CAPITAL,4B,VILLA REVOL,ESC ING MASJOAN - P.L.DE CABRERA ESQ.TANTI B°V. REVOL,10,254,263,3390
1,CAPITAL,4B,VILLA REVOL,COL NICOLAS BERROTARAN - ELIAS YOFRE 1095 - B° JARDIN,14,264,277,4746
1,CAPITAL,4C,INAUDI,ESC L SUAREZ DE FIGUEROA - DEFENSA S/N° LA HUERTILLA,6,278,283,1986
1,CAPITAL,4C,INAUDI,ESC SAN JOSE DE CALASANZ - PIZARRO ESQ. NIVOLI,7,284,290,2314
1,CAPITAL,4D,VILLA EUCARISTICA,COL VILLA EUCARISTICA - CNO A SAN CARLOS KM.5 1/2,6,291,296,1942
1,CAPITAL,4E,NUESTRO HOGAR III,ESC.SABIN - DDE.CMO.S.ANTONIO KM 7 1/2.1KM.AL O.,7,297,303,2135
1,CAPITAL,4F,CIUDAD OBISPO ANGELELLI,NSC.OSCAR RAUL MALVASIO - MANZANA 49 B° C.OBISPO ANGELELLI,7,304,310,2325
1,CAPITAL,5,ALTAMIRA,ESC ESPAÑA - M BRAVO Y ENTRE RIOS,16,311,326,5472
1,CAPITAL,5,ALTAMIRA,ESC GRECIA - PEDERNERA 952 B°SAN VICENTE,10,327,336,3420
1,CAPITAL,5,ALTAMIRA,ESC PANAMERICANA - SOTO 919 - B°ACOSTA,9,337,345,3078
1,CAPITAL,5,ALTAMIRA,ESC ESTANISLAO DEL CAMPO - ESTADOS UNIDOS Y RIO 1° B°ALTAMIRA,5,346,350,1706
1,CAPITAL,5A,COLONIA LOLA,ESC MUNICIPAL A GASTALDI - S JERONIMO 5500/ALMAGRO COL LOLA,6,351,356,1944
1,CAPITAL,5A,COLONIA LOLA,ELENA LOPEZ LALLANA - AGUSTIN GARZON 5.600,10,357,366,3234
1,CAPITAL,5B,DEAN FUNES,ESC 9 DE JULIO - JOSE A CABRERA 4717 B°DEAN FUNES,6,367,372,1892
1,CAPITAL,5C,EMPALME,ESC PROVINCIA DE LA RIOJA - JUNIN 3480 B°EMPALME,12,373,384,4080
1,CAPITAL,5C,EMPALME,ESC VICTOR MERCANTE - CAUCETE 4008 B°EMPALME,11,385,395,3740
1,CAPITAL,5C,EMPALME,ESC JUAN M DE PUEYRREDON - ANCASTI 4555 B°EMPALME,7,396,402,2380
1,CAPITAL,5C,EMPALME,INST SEC EMPALME GONZALEZ LACA - LAS ARRIAS 4043 B°EMPALME,5,403,407,1700
1,CAPITAL,5C,EMPALME,FRAY JUSTO STA MARÍA DE ORO - CALLAO 2.320,12,408,419,4075
1,CAPITAL,5C,EMPALME,ELENA LOPEZ LALLANA - AGUSTÍN GARZON 5.636,5,420,424,1695
1,CAPITAL,5D,MALDONADO,ESC CANONIGO PIÑERO - CAMPO LA RIBERA,6,425,430,2010
1,CAPITAL,5D,MALDONADO,ESC MARTIN DE GÜEMES - OBPO CASTELLANOS 256 B°MÜLLER,9,431,439,3015
1,CAPITAL,5D,MALDONADO,BAC TEC DR F ESCARDO - CAMPO LA RIBERA,9,440,448,3006
1,CAPITAL,5D,MALDONADO,IPEM 184-M.FRAGUEIRO - OB.CASTELLANO 955.S.VICENTE,8,449,456,2672
1,CAPITAL,5E,VILLA BUSTOS,ESC TTE GRAL P RICCHIERI - BENJAMIN VIEL 2387 - B°V BUSTOS,12,457,468,4055
1,CAPITAL,5F,RENACIMIENTO,ESC M COOPERATIVISMO ARGENTINO - M BRAVO Y PJE.MATHEUB° RENACIMIENTO,13,469,481,4482
1,CAPITAL,5G,SAN VICENTE,ESC SANTA MARGARITA DE CORTONA - LOPEZ Y PLANES 2936 B°SAN VICENTE,10,482,491,3450
1,CAPITAL,5G,SAN VICENTE,ESC DGO F SARMIENTO - LOPEZ Y PLANES 2253 B°SAN VICENTE,14,492,505,4830
1,CAPITAL,5G,SAN VICENTE,ESC PTE RIVADAVIA - AGUSTIN GARZON 1563 B°SAN VICENTE,12,506,517,4139
1,CAPITAL,5G,SAN VICENTE,ESC MARIA IGNACIA NAVARRO DE L - CORRIENTES 2006 B°SAN VICENTE,10,518,527,3440
1,CAPITAL,5H,VILLA BOEDO,ESC. MADRE MARIA DEL TRANSITO - MANZANA 7. B° VILLA BOEDO,6,528,533,1742
1,CAPITAL,5I,COLINAS DEL SUR,ESCUELA HEROES DE MALVINAS - CALLE PUBLICA S/N (CNO VILLA POSSE),8,534,541,2720
1,CAPITAL,5I,COLINAS DEL SUR,ESC.PTE. JUAN D.PERÓN - MANZANA 47.B° CIUDAD EVITA,6,542,547,2036
1,CAPITAL,6,ALTO GRAL PAZ,ESC TENIENTE GRAL ARAMBURU - GARIBALDI 710 B°ALTO GRAL PAZ,9,548,556,2988
1,CAPITAL,6,ALTO GRAL PAZ,COL   SAN RAMON NONATO - AVDA   PATRIA 282 B°ALTO GRAL PAZ,7,557,563,2317
1,CAPITAL,6A,BAJADA DE PIEDRA,ESC MUNICIPAL DR   A SOBRAL - PUBLICA S/N° B°SANGRE Y SOL,1,564,564,340
1,CAPITAL,6B,CHACRA DE LA MERCED,ESC VAN GELDEREN - CNO CHACRA DE LA MERCED KM 6 1/2,1,565,565,244
1,CAPITAL,6C,GRAL PAZ,ESC RAMON J CARCANO - VIAMONTE 446 B°GRAL.PAZ,11,566,576,3707
1,CAPITAL,6C,GRAL PAZ,ESC NORMAL GARZON AGULLA - VIAMONTE 150 B°GRAL PAZ,14,577,590,4718
1,CAPITAL,6C,GRAL PAZ,IPET N°10 COM MARTIN RIVADAVIA - 25 DE MAYO Y ROMA B°GRAL PAZ,10,591,600,3367
1,CAPITAL,6D,JUNIORS,ESC GABRIELA MISTRAL - LEONOR DE TEJEDA B°JUNIORS 1.353,10,601,610,3358
1,CAPITAL,6D,JUNIORS,ESC BRIGADIER C SAAVEDRA - ARENALES Y LA PLATA B°JUNIORS,11,611,621,3685
1,CAPITAL,6E,LA FLORESTA SUD,ESC TRANSITO CACERES DE ALLEND - CNO CHACRA DE LA MERCED KM 9 Y 1/2,7,622,628,2121
1,CAPITAL,6F,YAPEYU,ESC R GÜIRALDES - 24 DE SETIEMBRE 2400 B°YAPEYU,12,629,640,4128
1,CAPITAL,6F,YAPEYU,ESC GDOR AMADEO SABATTINI - GERMANIA 2500 B°YAPEYU,11,641,651,3774
1,CAPITAL,7,AEROPUERTO,ESC JORGE NEWBERY (CIRC 7F) - MATIENZO 5.895,1,652,652,150
1,CAPITAL,7A,GUIÑAZU,IPEM N° 22 JUAN FILLOY - CALLE DE LA CUECA,6,653,658,1992
1,CAPITAL,7A,GUIÑAZU,ESC UNESCO - JUAN B JUSTO/AV N SRA D LOS MILAGROS,14,659,672,4646
1,CAPITAL,7B,ALTA CORDOBA,ESC MANUEL LUCERO - MANUEL LUCERO 560 B°ALTA CORDOBA,19,673,691,6527
1,CAPITAL,7B,ALTA CORDOBA,ESC PCIA DE ENTRE RIOS - TRAFALGAR 875 B°ALTA CORDOBA,11,692,702,3773
1,CAPITAL,7B,ALTA CORDOBA,INST CORAZON DE MARIA - A DEL VISO 445 B°ALTA CORDOBA,14,703,716,4802
1,CAPITAL,7B,ALTA CORDOBA,INST NUESTRA MADRE DE LA MERCE - M FRAGUEIRO B°ALTA CORDOBA 2.400,13,717,729,4459
1,CAPITAL,7B,ALTA CORDOBA,INST MANUEL LUCERO - LAVALLEJA 2257 B°ALTA CORDOBA,9,730,738,3087
1,CAPITAL,7C,CNO. A PAJAS BLANCAS,ESC J NEWBERY - MATIENZO 5895 B°J NEWBERY,1,739,739,11
1,CAPITAL,7D,COFICO,ESC PTE SARMIENTO - R SAENZ PEÑA 1212 B°COFICO,11,740,750,3729
1,CAPITAL,7D,COFICO,ESC PCIA DE FORMOSA - RODRIGUEZ PEÑA 1548 B°COFICO,7,751,757,2370
1,CAPITAL,7D,COFICO,ESC. GARCIA FAURE - JERONIMO LUIS DE CABRERA 834,9,758,766,3042
1,CAPITAL,7E,MARQUES DE SOBREMONTE,ESC HONORATO LACONI - T DE IROBI B°M DE SOBREMONTE,14,767,780,4816
1,CAPITAL,7E,MARQUES DE SOBREMONTE,ESC PETER PAN - P DE GUZMAN 131 B°M DE SOBREMONTE,14,781,794,4816
1,CAPITAL,7E,MARQUES DE SOBREMONTE,J DE INF B.RIVADAVIA - NUFLO DE AGUILAR 541,3,795,797,1032
1,CAPITAL,7E,MARQUES DE SOBREMONTE,JOSE LUIS SERCIC - PEREZ CORREA 1500 M DE SOBREMONTE,8,798,805,2746
1,CAPITAL,7E,MARQUES DE SOBREMONTE,IPEM 338 - FRANCISCO SUAREZ 3.760,8,806,813,2744
1,CAPITAL,7F,JORGE NEWBERY,ESC JORGE NEWBERY - BENJAMIN MATIENZO Bº NEWBERY 5.895,10,814,823,3440
1,CAPITAL,7F,JORGE NEWBERY,ESC NACIONES UNIDAS - CTDA   8 S/N°B°R DE ESCALADA,9,824,832,3092
1,CAPITAL,7F,JORGE NEWBERY,IPEM 121 PAEZ MOLINA - ORIGONE ESQ CAROLA LORENZINI,5,833,837,1715
1,CAPITAL,7G,PANAMERICANO,ESC GOBERNADOR MANUEL LOPEZ - URQUIZA 4.800,7,838,844,2394
1,CAPITAL,7G,PANAMERICANO,ESC ARTURO CAPDEVILA - AVELLANEDA 4100 B°MFRAGUEIRO,12,845,856,4104
1,CAPITAL,7G,PANAMERICANO,ESC FRANCISCO VIDAL - FRAGUEIRO   (MANZANA "C") 4.200,12,857,868,4097
1,CAPITAL,7G,PANAMERICANO,IPEM 199 "JUAN EMILIO REMONDA" - SOSA REVELLO Y 15 DE SEPTIEMBRE 590,5,869,873,1705
1,CAPITAL,8,LA FLORESTA NORTE,ESC RABINDRANAT TAGORE - OCARINA 1613 - B° V CLAUDINA,3,874,876,702
1,CAPITAL,8A,PALMAR,ESC EMILIO E SANCHEZ - ANTONIO MACHONI 1.700,12,877,888,3931
1,CAPITAL,8B,PUEYRREDON,ESC FRAY J A DE SAN ALBERTO - ESQUIU 1340 B°PUEYRREDON,7,889,895,2408
1,CAPITAL,8B,PUEYRREDON,INST OBISPO CAIXAL - ANA M JANER 1250 B°PUEYRREDON,8,896,903,2752
1,CAPITAL,8B,PUEYRREDON,ESC DEAN FUNES - ANA M JANER 1551 B°PUEYRREDON,10,904,913,3439
1,CAPITAL,8B,PUEYRREDON,INST SAGRADO CORAZON - ROMA 1153 B°PUEYRREDON,10,914,923,3430
1,CAPITAL,8B,PUEYRREDON,ESC ROBLES - PADRE LUIS MONTI 1850 B°PUEYRREDON,12,924,935,4116
1,CAPITAL,8B,PUEYRREDON,INST SAGRADA FAMILIA - BUCHARDO 1729 B° PUEYRREDON,10,936,945,3430
1,CAPITAL,8C,VILLA LOS PINOS,ESC TRINIDAD MORENO - E SAN MARTIN 1251 B°YOFRE SUD,12,946,957,4044
1,CAPITAL,8C,VILLA LOS PINOS,ESC ALMIRANTE BROWN - SAN MARTIN S/N° B° YOFRE SUD,13,958,970,4373
1,CAPITAL,9,ESCOBAR,ESC PROVINCIA DE CORRIENTES - DOMINGO ZIPOLI 1358 B°ESCOBAR,8,971,978,2613
1,CAPITAL,9,ESCOBAR,INST ESCUTI - NAZARET 3399 - B° LAS ROSAS,10,979,988,3260
1,CAPITAL,9A,LA FRANCE,ESC MAHATMA GANDHI - TALAVERA DE MADRID 3261 B°LA FRANCE,7,989,995,2310
1,CAPITAL,9A,LA FRANCE,COL PQUIAL C NAMUNCURA - DIAGUITAS 3.314,8,996,1003,2632
1,CAPITAL,9B,LAS MARGARITAS,ESC RICARDO ROJAS - J.LOPEZ 2050 B°ALTOS DE V CABRERA,8,1004,1011,2656
1,CAPITAL,9B,LAS MARGARITAS,ESC CONGRESO DE TUCUMAN - MALVINO 2772 B°LAS MARGARITAS,6,1012,1017,1992
1,CAPITAL,9B,LAS MARGARITAS,ESC MIGUEL RODRIGUEZ DE LA TOR - LA GRANJA 3199 B°ALTO VERDE,10,1018,1027,3320
1,CAPITAL,9C,LOS PARAISOS,ESC DE COMERCIO J J PASO - PLATON 3030 B°LOS PARAISOS,10,1028,1037,3402
1,CAPITAL,9C,LOS PARAISOS,COLEGIO FERMIN LAFITTE - FCO VALLE 2443 B°LOS PARAISOS,10,1038,1047,3400
1,CAPITAL,9C,LOS PARAISOS,ESC JUVENILIA - ZARATE 2083 - B° ZUMARAN,7,1048,1054,2380
1,CAPITAL,9C,LOS PARAISOS,ESC PCIA DE MISIONES - FIRPO 2254 B° ZUMARAN,14,1055,1068,4760
1,CAPITAL,9D,POETA LUGONES,COL EL SALVADOR - RAUL CASARIEGO 4479 B°P LUGONES,8,1069,1076,2697
1,CAPITAL,9D,POETA LUGONES,ESC LEOPOLDO LUGONES - LESPADA Y GALVEZ B°POETA LUGONES,10,1077,1086,3370
1,CAPITAL,9D,POETA LUGONES,IPEM 198 MARTIN FERREYRA - CAMAÑO BAZAN E/CARLES Y A.GRIMAU,9,1087,1095,3033
1,CAPITAL,9E,PROVIDENCIA,ESC PTE HIPOLITO YRIGOYEN - CASTRO BARROS 802 B°SAN MARTIN,15,1096,1110,4903
1,CAPITAL,9F,SAN MARTIN,ESC ANTONIO DEL VISO - SAAVEDRA 619 B°SAN MARTIN,13,1111,1123,4407
1,CAPITAL,9F,SAN MARTIN,INST INMACULADA CONCEPCION - CASTRO BARROS 1316 B°SAN MARTIN,17,1124,1140,5749
1,CAPITAL,9F,SAN MARTIN,ESC J DE SAN MARTIN - CERRITO Y GALAN B°SAN MARTIN,7,1141,1147,2366
1,CAPITAL,9F,SAN MARTIN,COL NTRA SEÑORA DE LA MERCED - ZELAYA 140 B°SAN MARTIN,8,1148,1155,2704
1,CAPITAL,9G,VILLA CABRERA,INSTITUTO PEÑA - CIUDAD DE TAMPA 2954 VILLA CABRERA,10,1156,1165,3280
1,CAPITAL,9G,VILLA CABRERA,ESC PRESIDENTE KENNEDY - JULIAN PAZ 1851 VILLA CABRERA,8,1166,1173,2619
1,CAPITAL,10,BELLA VISTA,ESC ROQUE SAENZ PEÑA - AV VELEZ SARSFIELD 1000 B°GÜEMES,14,1174,1187,4774
1,CAPITAL,10,BELLA VISTA,INST EDUCACION CORDOBA - FERREYRA Y FRIULI B°COL DE V SARSF,18,1188,1205,6138
1,CAPITAL,10,BELLA VISTA,E.N.E.T. N°1 DR A SABATTINI - AV VELEZ SARSFIELD 1490 B°GÜEMES,10,1206,1215,3408
1,CAPITAL,10,BELLA VISTA,ESC MANUEL BELGRANO - SUECIA 2832 B° PQUE VELEZ SARSFIELD,9,1216,1224,3060
1,CAPITAL,10A,CABILDO,ESC MUN YAMAHIBIA ARABE LIBIA - COLORADO/GAIMAN/MASCACHIN B°CABILDO,9,1225,1233,3071
1,CAPITAL,10A,CABILDO,IPEM 311 - USUAHIA 2.150,5,1234,1238,1705
1,CAPITAL,10B,CIUDADELA,ESC PCIA DE CATAMARCA - AV VELEZ SARSFIELD 3200 LAS FLORES,17,1239,1255,5780
1,CAPITAL,10B,CIUDADELA,ESC REPUBLICA DE SIRIA - TRAFUL 908 B°PQUE ATLANTICA,6,1256,1261,2040
1,CAPITAL,10B,CIUDADELA,ESC GDOR J B BUSTOS - CACHEUTA Y BRANDAN-ALTO V.SARSFIELD,11,1262,1272,3729
1,CAPITAL,10B,CIUDADELA,J DE INF REPUBLICA DE SIRIA - VIRGILIO MOYANO 830,2,1273,1274,678
1,CAPITAL,10C,COMERCIAL,ESC ALEJANDRO CARBO - ICHO CRUZ S/N° B° COMERCIAL,15,1275,1289,5161
1,CAPITAL,10C,COMERCIAL,ESC MUNIC AZOR GRIMAUT - SOBREMONTE Y RIO III B°COMERCIAL,5,1290,1294,1720
1,CAPITAL,10D,CONGRESO,ESC MUNIC REPUBLICA DE ITALIA - REALICO Y CURAZAO B° CONGRESO,6,1295,1300,1974
1,CAPITAL,10D,CONGRESO,IPEM 183"PEDRO B.PALACIOS" - REALICO B° CONGRESO 2.407,4,1301,1304,1316
1,CAPITAL,10E,ESTACION FLORES,ESC CADETES FUERZA AEREA - LEOPOLDO CASAVEGA 2.320,11,1305,1315,3707
1,CAPITAL,10E,ESTACION FLORES,ESC PADRE BURON - AVIADOR MIRA - VILLA ADELA 2.658,8,1316,1323,2696
1,CAPITAL,10E,ESTACION FLORES,J DE INF CADETES FUERZA AEREA - LEOPOLDO CASAVEGA 2.320,1,1324,1324,337
1,CAPITAL,10E,ESTACION FLORES,ESC ALAS ARGENTINA - BONN 4.627,11,1325,1335,3698
1,CAPITAL,10E,ESTACION FLORES,ESC MUNIC CESAR E ROMERO - PUBLICA S/N B°SACHI,5,1336,1340,1680
1,CAPITAL,10F,MATIENZO,ESC AERONAUTICA ARGENTINA - ESMERALDA/CAP GRELLA B° MATIENZO,10,1341,1350,3370
1,CAPITAL,10F,MATIENZO,COL NUESTRA SEÑORA DE FATIMA - VARELA ORTIZ 2600 B° MATIENZO,13,1351,1363,4380
1,CAPITAL,10F,MATIENZO,ESC REPUBLICA ARGENTINA - SAN CAYETANO Y BRAILE B°AMEGHINO(S),7,1364,1370,2352
1,CAPITAL,10F,MATIENZO,ESC MIGUEL A ZABALA ORTIZ - DIAZ DE LA FUENTE 3101 B°MATIENZO,7,1371,1377,2352
1,CAPITAL,10G,OBSERVATORIO,E.N.E.T. N° 4 COPERNICO - MARIANO MORENO 551 B° OBSERVATORIO,26,1378,1403,8840
1,CAPITAL,10G,OBSERVATORIO,EE UU DE NORTEAMERICA - LA PAMPA 550 B°P DE LOS ANDES,10,1404,1413,3400
1,CAPITAL,10G,OBSERVATORIO,COL   NUESTRA SEÑORA DE NIEVA - AYACUCHO 442 B° GUEMES,19,1414,1432,6445
1,CAPITAL,10G,OBSERVATORIO,ESC ADOLFO SALDIAS - BOLIVAR 896 B° GÜEMES,7,1433,1439,2373
1,CAPITAL,10H,PARQUE CAPITAL,ESC GDOR EMILIO OLMOS - AV FUERZA AEREA B°PARQUE CAPITAL,10,1440,1449,3409
1,CAPITAL,10H,PARQUE CAPITAL,ESC R ESCALADA DE SAN MARTIN - ESPORA 2283 B°ROSEDAL,13,1450,1462,4420
1,CAPITAL,10H,PARQUE CAPITAL,ESC MUNIC DR A DEL CASTILLO - UNO ESQ DOCE B°AMPL ROSEDAL,7,1463,1469,2380
1,CAPITAL,10H,PARQUE CAPITAL,IPEM 154 MARTIN M DE GUEMES - O NAVARRO 2.751,6,1470,1475,2040
1,CAPITAL,10I,PARQUE HORIZONTE,PRIMARIA ELPIDIO TORRES - CALLE PUBLICA S/N,12,1476,1487,4080
1,CAPITAL,10I,PARQUE HORIZONTE,INST. SAN JOSE ARTESANO - CORONDA ESQ HUILICHES,6,1488,1493,2040
1,CAPITAL,10I,PARQUE HORIZONTE,IPEM 357 (SEC ELPIDIO TORRES) - CALLE PUBLICA S/N,11,1494,1504,3738
1,CAPITAL,10J,SANTA ISABEL,ESC BANDERA ARGENTINA - CASADO 634 STA ISABEL 1RA SECCION,11,1505,1515,3795
1,CAPITAL,10J,SANTA ISABEL,ESCUELA DON ORIONE - J.B.COTTOLENGO 1.955,11,1516,1526,3795
1,CAPITAL,10J,SANTA ISABEL,ESC MUNIC FERNANDEZ ORDOÑEZ - OLAVARRIA S/N° STA ISABEL 2DA SECC,6,1527,1532,2067
1,CAPITAL,10J,SANTA ISABEL,ESC.OSVALDO JORGE LEON - COLORADO ESQ LUAYABA,8,1533,1540,2752
1,CAPITAL,10K,VICOR,ESC BENITO SORIA - BARBADOS Y HAITI B° VICOR,15,1541,1555,4888
1,CAPITAL,10L,VILLA EL LIBERTADOR,IPEM 313 (ANEX0) - DEFENSA Y CACHEUTA.V.EL LIBERTADOR,6,1556,1561,2046
1,CAPITAL,10L,VILLA EL LIBERTADOR,ESC PROV DE SGO DEL ESTERO - CALLE 49 S/N° VILLA EL LIBERTADOR,8,1562,1569,2728
1,CAPITAL,10L,VILLA EL LIBERTADOR,ESC MARTA JUANA GONZALEZ - DEFENSA Y CACHEUTA B°V.EL LIBERTADOR 1.091,10,1570,1579,3410
1,CAPITAL,10L,VILLA EL LIBERTADOR,ESC MUNIC ALICIA MOREAU DE JUS - PILCOMAYO S/N°V EL LIBERTADOR,8,1580,1587,2728
1,CAPITAL,10L,VILLA EL LIBERTADOR,ESC PTE DR ARTURO U ILLIA - TOTORAL Y ARICA B°SANTA ROSA,11,1588,1598,3751
1,CAPITAL,10L,VILLA EL LIBERTADOR,COL SAN JOSE OBRERO - ARANI Y PJE. 17 V EL LIBERTADOR,6,1599,1604,2046
1,CAPITAL,10L,VILLA EL LIBERTADOR,J DE INF DR ARTURO U ILLIA - ARICA Y TOTORAL B°SANTA ROSA,4,1605,1608,1364
1,CAPITAL,10L,VILLA EL LIBERTADOR,ESC VICENTE FORESTIERI - ANIZACATE/CALLE 49 V. EL LIBERTADOR,9,1609,1617,3069
1,CAPITAL,10L,VILLA EL LIBERTADOR,IPEM 123BLANCA ECHEMENDI - IBARRA ESQUINA COSQUIN.VA.EL LIBERT.,10,1618,1627,3404
1,CAPITAL,10L,VILLA EL LIBERTADOR,ESC PATRICIAS MENDOCINAS - IBARRA ESQ FORESITERI,4,1628,1631,1360
1,CAPITAL,10M,AMPLIACION CABILDO,ESC PRIMARIA GRACIELA DEL RIO - B° AMPLIACION CABILDO,5,1632,1636,1555
1,CAPITAL,11,AERONAUTICO,ESC ISABEL LA CATOLICA - SUBOF OTANO S/N° B° AERONAUTICO,14,1637,1650,4503
1,CAPITAL,11A,ALTO ALBERDI,ESC PQUIAL SAN JOSE - VELEZ 252 B° ALTO ALBERDI,12,1651,1662,4092
1,CAPITAL,11A,ALTO ALBERDI,ESC SUP DE COMERCIO H VIEYTES - CASEROS Y VIEYTES B° ALTO ALBERDI,10,1663,1672,3410
1,CAPITAL,11A,ALTO ALBERDI,ESC BLAS PARERA - MONS DE ANDREA 1044 B° A ALBERDI,7,1673,1679,2387
1,CAPITAL,11A,ALTO ALBERDI,ESC SAN JOSE - CASEROS 3055 B° ALTO ALBERDI,11,1680,1690,3740
1,CAPITAL,11A,ALTO ALBERDI,ESC SAN LUIS GONZAGA - SANTA ROSA 2037 B° ALTO ALBERDI,9,1691,1699,3060
1,CAPITAL,11A,ALTO ALBERDI,ESC JOSE MARIA PAZ - AV COLON 2772 B° ALTO ALBERDI,15,1700,1714,5100
1,CAPITAL,11A,ALTO ALBERDI,ESC MOYANO COUDERT - DUARTE QUIROS 3950 ALTO ALBERDI,4,1715,1718,1360
1,CAPITAL,11B,DON BOSCO,INSTITUTO TECNICO DON BOSCO - J VESPIGNANI 215 B° DON BOSCO,9,1719,1727,3023
1,CAPITAL,11B,DON BOSCO,ESC ANTARTIDA ARGENTINA - B° GENERAL DEHEZA,11,1728,1738,3685
1,CAPITAL,11C,LAS PALMAS,ESC GRAL SAN MARTIN - AV COLON 4751 B°LAS PALMAS,17,1739,1755,5865
1,CAPITAL,11C,LAS PALMAS,ESC MANUEL E PIZARRO - DUARTE QUIROS 4725 B° LAS PALMAS,14,1756,1769,4817
1,CAPITAL,11C,LAS PALMAS,ESC MUNIC JUSTO PAEZ MOLINA - QUEBRACHO HERRADO Y YAVI LAS PALMAS,7,1770,1776,2408
1,CAPITAL,11C,LAS PALMAS,IPEM MARCELA B. MOYANO COUDERT - DUARTE QUIROS 3.915,5,1777,1781,1720
1,CAPITAL,11D,LOS NARANJOS,INST JESUS MARIA - VIEYTES SUD 1607 B° LOS NARANJOS,18,1782,1799,6196
1,CAPITAL,11D,LOS NARANJOS,ESC REPUBLICA DEL PERU - GOYENA Y GOMEZ CARRILLO,12,1800,1811,4128
1,CAPITAL,11D,LOS NARANJOS,ESC SANTISIMA TRINIDAD - BLAMEY LAFORE 1248 - B°SAN RAFAEL B,7,1812,1818,2408
1,CAPITAL,11E,LOS PLATANOS,ESC B DE MONTEAGUDO - SAN LUIS 3450 - B° LOS PLATANOS,12,1819,1830,4106
1,CAPITAL,11E,LOS PLATANOS,ESC JOSE MARMOL - AV LOS PLATANOS 1346,12,1831,1842,4104
1,CAPITAL,11E,LOS PLATANOS,ESC A CAPDEVILA - ALBERTO WILLIAMS ESQ.LOS PLATANOS,7,1843,1849,2394
1,CAPITAL,11E,LOS PLATANOS,ESC PADRE T GAMBINO - OCHO ESQ NUEVE B°LOS GRANADOS,10,1850,1859,3420
1,CAPITAL,11E,LOS PLATANOS,ESC.MUNIC.DR.CARLOS BECERRA - GAONA 1285,5,1860,1864,1710
1,CAPITAL,11F,LOS ROBLES,IPEM 205 HUGO PALLADINO - 27 DE ABRIL 5.330,12,1865,1876,4010
1,CAPITAL,11F,LOS ROBLES,ESC BATERIA LIBERTAD - POTRERILLO Y VENTA Y MEDIA,10,1877,1886,3340
1,CAPITAL,11G,PARQUE REPUBLICA,ESC PRIMER TTE AVILA - QUINCHAN 1.070,8,1887,1894,2736
1,CAPITAL,11G,PARQUE REPUBLICA,ESC PEREZ BULNES - J DE BARRIENTOS ESQ FORMOSA,12,1895,1906,4104
1,CAPITAL,11G,PARQUE REPUBLICA,ESC ATILIO ARGÜELLO - PUBLICA S/N B°PARQUE REPUBLICA,10,1907,1916,3417
1,CAPITAL,11G,PARQUE REPUBLICA,JARDIN TTE. AVILA - ALTO ALEGRE 1.050,2,1917,1918,682
1,CAPITAL,11G,PARQUE REPUBLICA,JORGE LUIS BORGES - ALTO ALEGRE/NAMUNCURA,6,1919,1924,2046
1,CAPITAL,11H,QUEBRADA LAS ROSAS,ESC GABRIELA MISTRAL - 27 DE ABRIL 5650 B°QUEB LAS ROSAS,10,1925,1934,3320
1,CAPITAL,11H,QUEBRADA LAS ROSAS,ESC REPUBLICA DE VENEZUELA - BOYERO 517 - B°CHATEAU CARRERAS,10,1935,1944,3319
1,CAPITAL,11I,RESIDENCIAL SAN ROQUE,ESC MUNIC LUZ VIEYRA MENDEZ - ABEL N DE CHAVEZ RES SAN ROQUE,10,1945,1954,3402
1,CAPITAL,11I,RESIDENCIAL SAN ROQUE,ESC MAURO FERNANDEZ - AV ALBARRACIN B°R SAN ROQUE 4.237,9,1955,1963,3060
1,CAPITAL,11I,RESIDENCIAL SAN ROQUE,J DE INF MAURO FERNANDEZ - GONZALEZ ALBARRACIN Y R ARIAS RSR,2,1964,1965,680
1,CAPITAL,11I,RESIDENCIAL SAN ROQUE,ESC.REPUBLICA DEL ECUADOR - HURTADO DE MENDOZA ESQ PEDRO ACUÑA,9,1966,1974,3060
1,CAPITAL,11I,RESIDENCIAL SAN ROQUE,HEROES DE MALVINAS - CNEL MANUEL NAMUNCURA/PETIROSSI,6,1975,1980,2040
1,CAPITAL,11I,RESIDENCIAL SAN ROQUE,INST. SEC. JUAN M. E ROSAS - CAMILOTTI ESQ SANTIBAÑEZ,8,1981,1988,2720
1,CAPITAL,11J,SANTA ANA,ESC ROMA - ECHEVERRIA 370 B°ALTO ALBERDI,17,1989,2005,5780
1,CAPITAL,11J,SANTA ANA,ESC LUTERANO CONCORDIA - SANTA ANA 2011 B°ALTO ALBERDI,16,2006,2021,5440
1,CAPITAL,11J,SANTA ANA,COLEGIO SAN JOSE - SOL DE MAYO 726 B° OBRERO,12,2022,2033,4080
1,CAPITAL,11J,SANTA ANA,ESC GENERAL MOSCONI - FERREYRA R 2324 B°OBRERO,6,2034,2039,2039
1,CAPITAL,11K,VILLA GRAL URQUIZA,ESC EJERCITO ARGENTINO - LA RIOJA 3453 - B° VILLA SIBURU,8,2040,2047,2752
1,CAPITAL,11K,VILLA GRAL URQUIZA,ESC MUNIC E BAQUERO LASCANO - HUMBERTO 1° ESQ IROS VILLA URQUIZA,6,2048,2053,2064
1,CAPITAL,11K,VILLA GRAL URQUIZA,ESC MUNIC JUAN B JUSTO - IGUALDAD 4100 VILLA URQUIZA,6,2054,2059,2064
1,CAPITAL,11K,VILLA GRAL URQUIZA,COL MADRE PAULA MONTAL - HUMBTO PRIMO Y FALUCHO V URQUIZA,6,2060,2065,2064
1,CAPITAL,11K,VILLA GRAL URQUIZA,IPEM 318 COMBATE DE LA TABLADA - LA TABLADA 4.861,6,2066,2071,2060
1,CAPITAL,11L,COUNTRYS DEL OESTE,INST.MARIA DE NAZARET - LOS ALAMOS (B° LA RUFINA) 1.111,8,2072,2079,2576
1,CAPITAL,11M,VALLE ESCONDIDO,ESC.S TURISMO Y HOT.M.PACHECO - AV.CARCANO (PREDIO FERIAR) 3.590,7,2080,2086,2310
1,CAPITAL,11M,VALLE ESCONDIDO,INSTITUTO VILLADA,5,2087,2091,1650
1,CAPITAL,12,AVELLANEDA,ESC JUAN XXIII - BENAVIDEZ Y CANESA - B°N AVELLANEDA,12,2092,2103,4020
1,CAPITAL,12,AVELLANEDA,ESC CONSTANCIO C VIGIL - J.LLERENA 5561 - B° SAN LORENZO,8,2104,2111,2679
1,CAPITAL,12,AVELLANEDA,ESC MUNIC OSCAR SOTO LOPEZ - LOS ALGARROBOS/ESPINILLOS,6,2112,2117,2004
1,CAPITAL,12A,CARCANO,ESC.PROF.M.LUCIANI - 11 DE SEPTIEMBRE ESQ. CALLE 2CARCANO 4.400,8,2118,2125,2752
1,CAPITAL,12A,CARCANO,ESC.MA.DEL TRANSITO CABANILLAS - CNO.SAN ANDRES/RUIZ HUIDOBRO,8,2126,2133,2745
1,CAPITAL,12B,COLON,ESC RUBEN DARIO - LA CORUÑA Y MONSERRAT B°CRISOL,13,2134,2146,4459
1,CAPITAL,12B,COLON,INST NTRA SRA DEL SGDO CORAZON - REVOLUCION DE MAYO 1476 B°COLON,17,2147,2163,5826
1,CAPITAL,12B,COLON,ESC BARTOLOME HIDALGO - TEJEDOR 1958 B°SARMIENTO,7,2164,2170,2394
1,CAPITAL,12B,COLON,ESC JUAN LARREA - LUIS BRAILE 2273 B°SARMIENTO,8,2171,2178,2736
1,CAPITAL,12B,COLON,ESC HILARIO ASCASUBI - LUCIO V.MANSILLA ESQ. CADIZ,10,2179,2188,3420
1,CAPITAL,12B,COLON,INST MANUEL BELGRANO - LUIS BRAILE 2384 B°SARMIENTO,8,2189,2196,2736
1,CAPITAL,12B,COLON,ESC DR LUIS A CAEIRO - ORTIZ Y HERRERA 1932 B°CRISOL N,4,2197,2200,1368
1,CAPITAL,12C,CORONEL OLMEDO,ESC CORONEL OLMEDO - ALTOLAGUIRRE B°CNEL OLMEDO 4.060,14,2201,2214,4524
1,CAPITAL,12D,JOSE IGNACIO DIAZ,ESC MONSEÑOR M DE ANDREA - 17 DE JULIO 380 B°FVRO MITRE,10,2215,2224,3430
1,CAPITAL,12D,JOSE IGNACIO DIAZ,ESC PEDRO GOYENA - PJE GUASTONI 3472 B° BRIG S MARTIN,13,2225,2237,4459
1,CAPITAL,12D,JOSE IGNACIO DIAZ,ESC MUNICIPAL DR A SABATTINI - DIEGO DE PACHECO 4.900,8,2238,2245,2744
1,CAPITAL,12D,JOSE IGNACIO DIAZ,ESC MUNIC DR ARTURO H ILLIA - CHIRINO DE POSADAS ESQ.MAGUNA 4.600,8,2246,2253,2740
1,CAPITAL,12D,JOSE IGNACIO DIAZ,ESC MUNIC DOMINGO F SARMIENTO - MANZANA 63. B° 23 DE ABRIL(CNOINTERF,7,2254,2260,2394
1,CAPITAL,12D,JOSE IGNACIO DIAZ,CENTRO EDUC.ING.REGINO M.MADER - CHIRINO DE POSADAS 5400 B°S.FELIPE,8,2261,2268,2736
1,CAPITAL,12D,JOSE IGNACIO DIAZ,POETA OSCAR GUIÑAZU ALVAREZ - ASTURIAS 3.345,8,2269,2276,2736
1,CAPITAL,12D,JOSE IGNACIO DIAZ,IPEM N° 309 (FUENTEALBA) - CALLE PUBLICA,6,2277,2282,2052
1,CAPITAL,12D,JOSE IGNACIO DIAZ,ESC. MARIA EVA DUARTE - CALLE PUBLICA S/N (CNO 60 CUAD KM3),6,2283,2288,2052
1,CAPITAL,12E,FERREYRA,ESC REPUBLICA DE COSTA RICA - RUTA 9 KM 8 1/2,5,2289,2293,1705
1,CAPITAL,12E,FERREYRA,ESC LIBERTADOR GRAL S MARTIN - SGO MORALES 4400 B°FERREYRA,9,2294,2302,3069
1,CAPITAL,12F,JOSE HERNANDEZ,ESC MUNIC E MOLINARI ROMERO - PAMPAYASTA Y RUMIPAL B°PQUE SCARLOS,9,2303,2311,3105
1,CAPITAL,12F,JOSE HERNANDEZ,ESC MUNIC BRIG JUAN I DE S MAR - BRAGADO/TRENQUE LAUQUEN B°J HERNDEZ,7,2312,2318,2415
1,CAPITAL,12F,JOSE HERNANDEZ,ESC GRAL MANUEL BELGRANO - OLAEN Y AMBOY - B° OÑA,11,2319,2329,3795
1,CAPITAL,12F,JOSE HERNANDEZ,ESC EJERCITO ARGENTINO - CASTAÑARES 470 - B°JARDIN DEL PILAR,8,2330,2337,2760
1,CAPITAL,12F,JOSE HERNANDEZ,COL.JOVENES ARGENTINOS - BOTAFOGO 3448 B° J.ESPINOSA,7,2338,2344,2410
1,CAPITAL,12F,JOSE HERNANDEZ,IPEM 167 JOSE MANUEL ESTRADA - B. DE O'HIGGINS 2.656,10,2345,2354,3440
1,CAPITAL,12F,JOSE HERNANDEZ,ESCUELA ADVENTISTA HECTOR RHYS - TANINGA 3.152,5,2355,2359,1720
1,CAPITAL,12G,ITUZAINGO,ESC PRIMARIA CARLOS M DE ALVEA - VUCETICH 6410 B°ITUZAINGO,7,2360,2366,2387
1,CAPITAL,12G,ITUZAINGO,ESC EJERCITO ARGENTINO - STEPHENSON Y FULTON B°ITUZAINGO,14,2367,2380,4761
1,CAPITAL,12G,ITUZAINGO,ESC SECUNDARIA CARLOS M DE ALV - FARADAY 5721 B°LOS EUCALIPTUS,6,2381,2386,2040
1,CAPITAL,12G,ITUZAINGO,ESC DR IGNACIO DUARTE QUIROS - FARADAY 5.168,4,2387,2390,1360
1,CAPITAL,12H,LOS CERVECEROS,ESC MADRE TERESA DE CALCUTA - PALAMARA 2.900,8,2391,2398,2688
1,CAPITAL,12H,LOS CERVECEROS,ESC RAUL A FERREYRA - PUBLICA S/N -ALTURA AV O'HIGGINS 3.500,8,2399,2406,2688
1,CAPITAL,12H,LOS CERVECEROS,ESC JOSE M ESTRADA - AV B DE O'HIGGINS KM 8 1/2,6,2407,2412,2016
1,CAPITAL,12H,LOS CERVECEROS,J DE INF RAUL A.FERREYRA - B DE O'HIGGINS 3500 B°S.E.P,3,2413,2415,1008
1,CAPITAL,12H,LOS CERVECEROS,ESC.DR.NICOLAS AVELLANEDA - CNO.S.CARLOS KM. 4 1/2,6,2416,2421,2015
1,CAPITAL,12I,CIUDAD DE MIS SUEÑOS,ESC. PRIMARIA MARIA SALEME - RUTA 9 KM 690,7,2422,2428,2326
1,CAPITAL,13,LEANDRO N. ALEM,ESC PADRE DIEGO DE TORRES - DIAG ICA Y CAMICALTA B°L N ALEM,12,2429,2440,4111
1,CAPITAL,13,LEANDRO N. ALEM,ESC ARISTOBULO DEL VALLE - M DE JAUREGUI 1657 B°L N ALEM,10,2441,2450,3420
1,CAPITAL,13,LEANDRO N. ALEM,ESC ASOCIACION DE MAYO - COLOMPREA 1500 B° ALEM,5,2451,2455,1710
1,CAPITAL,13A,AYACUCHO,ESC HENOCH D AGUIAR - J DE OLMEDO 650 B°LOS GIGANTES,10,2456,2465,3440
1,CAPITAL,13A,AYACUCHO,ESC FRANCISCO A RIZZUTO - FDO DE LESSEPS 140 B°CENTRO AMERICA,13,2466,2478,4464
1,CAPITAL,13A,AYACUCHO,ESC R SANCHEZ DE CALDELARI - ALVAREZ DE LAS CASAS 280   AYACUCHO,10,2479,2488,3430
1,CAPITAL,13A,AYACUCHO,ESC P ALBARRACIN DE SARMIENTO - NERUDA Y ACAMPES B° VILLA AZALAIS,11,2489,2499,3773
1,CAPITAL,13A,AYACUCHO,ESC MUNIC DR P CARANDE CARRO - MARTINEZ PAZ 80 B°CENTRO AMERICA,5,2500,2504,1715
1,CAPITAL,13B,EL GATEADO,ESC FLORENCIO SANCHEZ - RUTA 111 KM 12,1,2505,2505,146
1,CAPITAL,13C,GENERAL BUSTOS,ESC CAPITAL FEDERAL - MAURICIO YADAROLA 653 B°GRAL BUSTOS,11,2506,2516,3718
1,CAPITAL,13C,GENERAL BUSTOS,ESC CRISTO REY - CURA BROCHERO B°GRAL BUSTOS 753,7,2517,2523,2366
1,CAPITAL,13C,GENERAL BUSTOS,ESC ALEJO CARMEN GUZMAN - AUGUSTO LOPEZ 643 B°GRAL BUSTOS,13,2524,2536,4384
1,CAPITAL,13C,GENERAL BUSTOS,COLEGIO HORTUS CONCLUSUS - GIANELLI 500 B°GRAL BUSTOS,10,2537,2546,3370
1,CAPITAL,13D,JARDIN ARENALES,ESC MUNIC J GONZALEZ - CINCO S/N°B°JARDIN ARENALES,8,2547,2554,2553
1,CAPITAL,13E,LA DOROTEA,ESC REPUBLICA DE LA INDIA - CNO MONTE CRISTO KM 5,4,2555,2558,1215
1,CAPITAL,13F,NUEVA ITALIA,ESC MODELO RACING - TREDENTINA B°NUEVA ITALIA 2.160,11,2559,2569,3740
1,CAPITAL,13F,NUEVA ITALIA,ESC SGTO CABRAL - P DE LEDESMA B°PQUE MTE CRISTO 1.755,10,2570,2579,3397
1,CAPITAL,13F,NUEVA ITALIA,CENTRO VECINAL ZONA 111 - TREDENTINA 1945 B°NUEVA ITALIA,2,2580,2581,678
1,CAPITAL,13G,PARQUE LICEO,ESC RICARDO ROJAS - STORNI Y MONTALVO B°LICEO 2DA SECC,14,2582,2595,4760
1,CAPITAL,13G,PARQUE LICEO,ESC ESPIRITU SANTO - ISAAC 4.847,25,2596,2620,8480
1,CAPITAL,13G,PARQUE LICEO,ESC MUNIC GDOR A ZANICHELLI - STORNI S/N B°PQUE LICEO 3RA SECC,7,2621,2627,2373
1,CAPITAL,13G,PARQUE LICEO,ESC. PRIMARIA EVA DUARTE - BARTOLOME HIDALGO 1.140,7,2628,2634,2373
1,CAPITAL,13H,PATRICIOS,ESC JOSE MARIA PAZ - USANDIVARAS 2254 B°PATRICIOS,11,2635,2645,3740
1,CAPITAL,13H,PATRICIOS,COL HIJAS DE MARIA INMACULADA - MADRE BRIGIDA PASTORINO 2.733,15,2646,2660,5095
1,CAPITAL,13H,PATRICIOS,ESC PARROQUIAL SAN ROQUE - USANDIVARAS 2050 VILLA CORINA,8,2661,2668,2712
1,CAPITAL,13H,PATRICIOS,ESC MANUEL BELGRANO - ABRAMO 2545 B°BELGRANO,12,2669,2680,4068
1,CAPITAL,13H,PATRICIOS,ESC MUNIC DR D LATELLA FRIAS - H DE AYOHUMA S/N B°PATRICIOS,5,2681,2685,1695
1,CAPITAL,13I,SAN JORGE,ESC MUNIC JORGE LUIS BORGES - QUINTA SAN JORGE,7,2686,2692,2345
1,CAPITAL,13I,SAN JORGE,ESC MUNIC DR ALFREDO ORGAZ - PUBLICA S/N B°QTAS SAN JORGE II,7,2693,2699,2343
1,CAPITAL,13I,SAN JORGE,ESC MUNIC. MONSEÑOR ANGELELLI - FEDERICO RAUCH 2.790,4,2700,2703,1336
1,CAPITAL,13J,VILLA AZALAIS,ESC A CAPDEVILA/ DR. B HOUSEY - A CAPDEVILA 709 Y BILIBISACATE,11,2704,2714,3762
1,CAPITAL,13J,VILLA AZALAIS,ESC CURA BROCHERO - JAMAICA 967 B°RESID AMERICA,12,2715,2726,4104
1,CAPITAL,13J,VILLA AZALAIS,ESC GDOR H DEL CASTILLO - GELLY Y OBES 3110 VILLA AZALAIS,9,2727,2735,3078
1,CAPITAL,13J,VILLA AZALAIS,ESC PARROQUIAL L STUCCHI BAUDO - NUEVO MUNDO 824 B°RESID AMERICA,11,2736,2746,3753
1,CAPITAL,13J,VILLA AZALAIS,ESC JUSTO PAEZ MOLINA - J MONTAÑO 1350 B° VILLA AZALAIZ,14,2747,2760,4774
1,CAPITAL,13J,VILLA AZALAIS,ESC VICENTE F LOPEZ - TISSERA 1551 B° L N ALEM,15,2761,2775,5115
1,CAPITAL,13J,VILLA AZALAIS,ESC MUNIC J A PAREDES - FCO DEL PRADO 3900 V AZALAIS,8,2776,2783,2728
1,CAPITAL,13J,VILLA AZALAIS,I.P.E.T N° 70 - AV JUAN B JUSTO 4.350,11,2784,2794,3751
1,CAPITAL,13K,VILLA ESQUIU,DR JOSE RAMON IBAÑEZ - CAPDEVILLA KM 9 1/2,7,2795,2801,2110
1,CAPITAL,13L,VILLA GRAN PARQUE,ESC JORGE WASHINGTON ABALOS - CNO J MARIA KM 8 1/2,2,2802,2803,420
1,CAPITAL,13M,CAMINO A COLONIA TIROLESA,ESC OLEGARIO V ANDRADE - CNO SGO DEL ESTERO KM 7 1/2,2,2804,2805,460
1,CAPITAL,13N,YOFRE,ESC DR ANTONIO NORES - JULIO DE VEDIA 2.353,13,2806,2818,4429
1,CAPITAL,13N,YOFRE,ESC MATEO J LUQUE - JACINTO DE ALTOLAGUIRRE B°YOFRE NORT 2.089,9,2819,2827,3060
1,CAPITAL,13O,CHACHAPOYAS,ESC. CARLOS TAGLE ACHAVAL - MANZANA 22 B°CIUDAD DE LOS CUARTETOS,4,2828,2831,1265
1,CAPITAL,14,ARGUELLO,COLEGIO LA SALLE - AV MARTINOLI 3950,14,2832,2845,4662
1,CAPITAL,14,ARGUELLO,COLEGIO DEL CARMEN - RECTA MARTINOLI B°ARGÜELLO,6,2846,2851,1994
1,CAPITAL,14A,ARGUELLO NORTE,ESC BRIG SAN MARTIN - DOMINGO MARIMON/GABRIEL ORTEGA,15,2852,2866,5086
1,CAPITAL,14A,ARGUELLO NORTE,ESC RICARDO NASSIF - MARTIN FERMIN B°ARGÜELLO NORTE,13,2867,2879,4407
1,CAPITAL,14A,ARGUELLO NORTE,ESC HUGO LEONELLI - ALBERTO FAGE/JULIO BEJANELE,10,2880,2889,3390
1,CAPITAL,14A,ARGUELLO NORTE,ESC MARTHA A SALOTTI - PUBLICA S/N IPV SECTOR360ARGÜELLO N,13,2890,2902,4407
1,CAPITAL,14B,ARGUELLO PRIMERO,ESC MARTIN DE GÜEMES - MONTUFAR Y CORONADO 7.126,8,2903,2910,2664
1,CAPITAL,14B,ARGUELLO PRIMERO,ESC MUNIC RAUL V MARTINEZ - NILO PECANHA S/N B°QTAS DE ARGÜELLO,8,2911,2918,2660
1,CAPITAL,14B,ARGUELLO PRIMERO,ESC ELISA K DE LIVACK - CUIMAN B°LA SALLE 6.543,6,2919,2924,1992
1,CAPITAL,14C,ARGUELLO SEGUNDO,INST CONCEPCIONISTA LA INMACUL - AV ENRIQUE BODEREAU KM 14,14,2925,2938,4650
1,CAPITAL,14D,CERRO DE LAS ROSAS,ESC INGENIERO VICTOR REE - FDO FADER 3821 B°C DE LAS ROSAS,9,2939,2947,3099
1,CAPITAL,14D,CERRO DE LAS ROSAS,ESC JUAN ZORRILA DE SAN MARTIN - JOSE E BUSTOS 1875 C DE LAS ROSAS,11,2948,2958,3784
1,CAPITAL,14E,CERRO NORTE,ESC MODESTA RODRIGUEZ - HNOS GRIMM 7168 B°UOCRA,5,2959,2963,1703
1,CAPITAL,14E,CERRO NORTE,ESC NIÑAS DE AYOHUMA - VALERIO BETA B°ARGUELLO (N) 7.300,9,2964,2972,3060
1,CAPITAL,14E,CERRO NORTE,ESC GERONIMO GRAGERA - MOLLEYACO/PAYEN,5,2973,2977,1700
1,CAPITAL,14F,GRANJA DE FUNES,ESC DR ALEJANDRO GALLARDO - TRINIDAD ESQ ITALIA B°SILVANO FUNES,11,2978,2988,3688
1,CAPITAL,14F,GRANJA DE FUNES,ESC JAVIER LAZCANO COLODRERO - CARLOS BROGGI S/N° B°ARGÜELLO,9,2989,2997,3015
1,CAPITAL,14G,LOS BOULEVARES,ESC MUNIC ING MASJOAN - 2/TUCUMAN Y MENDOZA LOS BOULEVARES,9,2998,3006,3015
1,CAPITAL,14G,LOS BOULEVARES,ESC JUAN MARIA GUTIERREZ - BV LOS ALEMANES 4.200,9,3007,3015,3007
1,CAPITAL,14G,LOS BOULEVARES,ESC. F. LELOIR - LOS POLACOS 6.072,9,3016,3024,3006
1,CAPITAL,14H,MERCANTIL,ESC ARTEMIO ARAN - PUBLICA ESQ JACINTO YABEN,6,3025,3030,1968
1,CAPITAL,14H,MERCANTIL,ESC MUNIC MAESTRO M OLIVA - REVELTO ESQ TOMASINI B°MERCANTIL,5,3031,3035,1638
1,CAPITAL,14I,SANTA CECILIA,ESC MAESTROS PUNTANOS - CINCO N°25 B°AMPL P LUGONES,7,3036,3042,2402
1,CAPITAL,14I,SANTA CECILIA,ESC MUNIC ARSENIO MURUGARREN - PIZARRO Y GRASS B°SANTA CECILIA,8,3043,3050,2744
1,CAPITAL,14J,URCA,INSTITUTO EMILIO LAMARCA - AV EMILIO LAMARCA 4.245,9,3051,3059,3024
1,CAPITAL,14J,URCA,ESC REPUBLICA DE PANAMA - TRECE BIS   COL   DEL CERRO,7,3060,3066,2352
1,CAPITAL,14J,URCA,ESC REPUBLICA DEL LIBANO - IGARZABAL 1250 B°URCA,8,3067,3074,2687
1,CAPITAL,14K,VILLA ALLENDE PARQUE,ESC MUNIC DR RAUL FERNANDEZ - 12 Y 14 VILLA ALLENDE PQUE,8,3075,3082,2619
1,CAPITAL,14K,VILLA ALLENDE PARQUE,JARDIN MATERNAL TRAVESURAS - MULUCHES S/N,3,3083,3085,981
1,CAPITAL,14L,VILLA BELGRANO,ESC NUEVA JUAN MANTOVANI - AVOGADRO Y GAUSS VILLA BELGRANO,8,3086,3093,2656
1,CAPITAL,14L,VILLA BELGRANO,ESC RICARDO PALMA - D'ALEMBERT Y GAUSS,8,3094,3101,2654
1,CAPITAL,14M,VILLA CENTENARIO,INST   SAUL TABORDA - OB MOSCOSO Y PERALTA 2772 A PALERMO,13,3102,3114,4355
1,CAPITAL,14M,VILLA CENTENARIO,ESC PRIMERA JUNTA - C DE ARREDONDO 4446 B°CENTENARIO,13,3115,3127,4347
1,CAPITAL,14M,VILLA CENTENARIO,ESC LUZ VIEYRA MENDEZ - OB MOSCOSO Y PERALRA 2772,3,3128,3130,1002
1,CAPITAL,14N,VILLA CORNU,ESC MUNIC DR HORACIO GARCIA - PUBLICA S/N°V CORNU,9,3131,3139,2966
1,CAPITAL,14N,VILLA CORNU,IPEM 16 MA.SALEME DE BURNICHON - AL LADO ESC. H. GARCIA,7,3140,3146,2303
1,CAPITAL,14O,VILLA 9 DE JULIO,INSTITUTO LEON XIII - AV BODEREAU 7.850,16,3147,3162,5274
1,CAPITAL,14O,VILLA 9 DE JULIO,ESC MUNIC SAUL TABORDA - COQUENA (VILLA 9 DE JULIO) 7.985,6,3163,3168,1974
1,CAPITAL,14P,VILLA RIVERA INDARTE,ESC MUNIC DR JORGE ORGAZ - LAGUNA LARGA/R LUNA V R INDARTE,7,3169,3175,2353
1,CAPITAL,14P,VILLA RIVERA INDARTE,IPEM N° 17 - LAGUNA LARGA ESQ.RINCON DE LUNA,4,3176,3179,1344
1,CAPITAL,14Q,VILLA WARCALDE,INST. TEC. ISAAC NEWTON - MOLINO DE TORRES 6.635,4,3180,3183,1168
2,CALAMUCHITA,15,AMBOY,ESC PROV D VELEZ SARFIELD - AYLLU,1,3184,3184,240
2,CALAMUCHITA,15A,VILLA AMANCAY,ESC.PROV.R.SAENZ PEÑA - CALLE 6,2,3185,3186,505
2,CALAMUCHITA,16,ATHOS PAMPA,ESC PROV. M.BELGRANO - PUBLICA S/N,1,3187,3187,151
2,CALAMUCHITA,16A,VILLA LA MERCED,ESCUELA N° 404 - VILLA LA MERCED,1,3188,3188,34
2,CALAMUCHITA,16B,CHAMPAQUI,ESC.PROV. F.AMEGHINO - CHAMPAQUI,1,3189,3189,12
2,CALAMUCHITA,16C,VILLA BERNA,ESC. JOAQUIN V. GONZALEZ - PUBLICA,1,3190,3190,106
2,CALAMUCHITA,17,EMBALSE,IPEA Y T 347 - J LUIS DE CABRERA ESQ ACONCAGUA,12,3191,3202,4062
2,CALAMUCHITA,17,EMBALSE,ESCUELA B. ROLDAN - TUCUMAN 121,9,3203,3211,3042
2,CALAMUCHITA,18,LA CRUZ,ESC PROV DOMINGO F SARMIENTO - SARMIENTO 376,3,3212,3214,922
2,CALAMUCHITA,18,LA CRUZ,INST DR D VELEZ SARSFIELD - SARMIENTO 236,2,3215,3216,614
2,CALAMUCHITA,18A,LUTTI,ESC. PROV. L. LUGONES - PUBLICA,1,3217,3217,157
2,CALAMUCHITA,18B,CALERAS DE CALAMUCHITA,ESCUELA PROVINCIAL - CALERAS DE CALAMUCHITA,1,3218,3218,202
2,CALAMUCHITA,18C,VILLA CAÑADA DEL SAUCE,ESC.PROV. A.ALSINA - FRANCISCO CESAR,1,3219,3219,80
2,CALAMUCHITA,18D,VILLA QUILLINZO,ESC.PROV.PADRE FELIX ENRIQUE - VILLA QUILLINZO,1,3220,3220,160
2,CALAMUCHITA,19,LOS CONDORES,ESC. PROV. FRENCH Y BERUTTI - LOS CONDORES,5,3221,3225,1575
2,CALAMUCHITA,19,LOS CONDORES,COLEGIO SAGRADO CORAZON - AV DON BOSCO 101,4,3226,3229,1258
2,CALAMUCHITA,20,LOS REARTES,ESC PROV PEDRO B PALACIOS - MANUEL BELGRANO S/N,4,3230,3233,1328
2,CALAMUCHITA,20A,VILLA GENERAL BELGRANO,ESC.GRAL J. DE SAN MARTIN - VILLA GRAL.BELGRANO,9,3234,3242,3069
2,CALAMUCHITA,20A,VILLA GENERAL BELGRANO,ESC. DE COM. D. DE ROJAS - VILLA GRAL.BELGRANO,8,3243,3250,2728
2,CALAMUCHITA,20A,VILLA GENERAL BELGRANO,COLEGIO ARGENTINO GERMANO - VILLA GRAL.BELGRANO,5,3251,3255,1704
2,CALAMUCHITA,20B,VI.CIUD.PQUE.LOS REARTES,ESC ELOY GOMEZ ANEXO (PRIMARIA - VILLA CIUDAD PQUE LOS REARTES,4,3256,3259,1095
2,CALAMUCHITA,21,LAS BAJADAS,ESC. DR. JUAN M. ALBARENQUE - PUBLICA,1,3260,3260,269
2,CALAMUCHITA,22,RIO DE LOS SAUCES,ESC. PROV. D.F. SARMIENTO - SARMIENTO,4,3261,3264,1109
2,CALAMUCHITA,23,VILLA YACANTO,ESC.PROV. FRENCH Y BERUTTI - CORDOBA,5,3265,3269,1443
2,CALAMUCHITA,24,RUMIPAL,ESC PROV PRIMERA JUNTA - AMADEO SABATTINI 143,8,3270,3277,2439
2,CALAMUCHITA,24A,VILLA DEL DIQUE,ESC.PROV.ALMIRANTE BROWN - SARMIENTO 279,10,3278,3287,3325
2,CALAMUCHITA,25,SAN AGUSTIN,ESC. PROV.GRAL. SAN MARTIN - SAN AGUSTIN,5,3288,3292,1705
2,CALAMUCHITA,25,SAN AGUSTIN,COLEGIO SAN JOSE - SAN AGUSTIN,4,3293,3296,1361
2,CALAMUCHITA,25A,CALMAYO,ESC.PROV.M.GUEMES - PUBLICA,1,3297,3297,126
2,CALAMUCHITA,25B,LOS MOLINOS,ESC PROV JUAN LARREA - PUBLICA S/N,1,3298,3298,301
2,CALAMUCHITA,26,SANTA ROSA,INST PARR SAN JUAN DIEGO - AV INT ANGEL LLANOS 320,10,3299,3308,3430
2,CALAMUCHITA,26,SANTA ROSA,PRIM-EL MUNDO DE LOS CHICOS - GUEMES 162,5,3309,3313,1712
2,CALAMUCHITA,26,SANTA ROSA,ESC. PROV.M. MORENO - SANTA ROSA,10,3314,3323,3420
2,CALAMUCHITA,26,SANTA ROSA,COLEGIO NAC. DR.D.V. SARSFIELD - SANTA ROSA,9,3324,3332,3078
2,CALAMUCHITA,26A,SEGUNDA USINA,ESCUELA N° 481 - SEGUNDA USINA,1,3333,3333,131
2,CALAMUCHITA,26B,SAN IGNACIO,ESC.PROV.DEAN FUNES - SAN IGNACIO,1,3334,3334,130
2,CALAMUCHITA,328A,LA CUMBRECITA,ESC BARTOLOME MITRE - PUBLICA S/N,3,3335,3337,762
3,COLON,27,ASCOCHINGA,ESCUELA DR. PABLO RUEDA - LA GRANJA,6,3338,3343,1880
3,COLON,27,ASCOCHINGA,ESC ING ALBERTO R MASCIAS - PUBLICA S/N,4,3344,3347,1252
3,COLON,28,CALERA,ESC ELADIO DIEZ - ALVEAR ESQ SARMIENTO,8,3348,3355,2736
3,COLON,28,CALERA,IPEM N° 73 - REP DE CHILE ESQ GRAL CABRERA,8,3356,3363,2736
3,COLON,28,CALERA,INSTITUTO D.F.SARMIENTO - CALERA,17,3364,3380,5814
3,COLON,28,CALERA,ESCUELA PROV.J.J.PASO-CENMA - CALERA,11,3381,3391,3762
3,COLON,28,CALERA,INSTITUTO JESUS MARIA - CALERA,7,3392,3398,2391
3,COLON,28A,CALERA CENTRAL,JARDIN IBARSABAL - RONDEAU 814,3,3399,3401,1026
3,COLON,28A,CALERA CENTRAL,ESC.TTE. J.R. IBARZABAL - CALERA CENTRAL,15,3402,3416,5130
3,COLON,28A,CALERA CENTRAL,CENTRO EDUCATIVO GRAL SAN MART - CALERA CENTRAL,9,3417,3425,3076
3,COLON,28A,CALERA CENTRAL,EX ANEXO MARGARITA W DE PAZ - AVELLANEDA 684,9,3426,3434,3069
3,COLON,29,COLONIA CAROYA,COLEGIO PIO LEON - AV 28 DE JULIO 345,12,3435,3446,4080
3,COLON,29,COLONIA CAROYA,ESC.PROV. M. BELGRANO - COLONIA CAROYA,10,3447,3456,3400
3,COLON,29,COLONIA CAROYA,ESC. PROV. GRAL SAN MARTIN - MAESTRA OLGA PROSDOCIMO 3.580,10,3457,3466,3400
3,COLON,29,COLONIA CAROYA,ESC. PRESBITERO BONORIS - COLONIA CAROYA,11,3467,3477,3737
3,COLON,29,COLONIA CAROYA,ESCUELA M. MORENO - JUSTINIANO CELIZ HEREDIA 650,6,3478,3483,2034
3,COLON,29A,TINOCO,ESC.PROV.B.RIVADAVIA - PUBLICA,1,3484,3484,263
3,COLON,30,COLONIA TIROLESA,IPET 83 RENE FAVALORO - ARTURO ILLIA 505,9,3485,3493,2991
3,COLON,30,COLONIA TIROLESA,ESC PROV DR PABLO RUEDA - PUBLICA S/N,7,3494,3500,2324
3,COLON,31,EL MANZANO,ESC.PROV.A.ARGENTINA - EL MANZANO SOBRE RUTA E 53,4,3501,3504,1129
3,COLON,31A,AGUA DE ORO,ESC.PROV.V.MERCANTE - AGUA DE ORO,4,3505,3508,1269
3,COLON,31A,AGUA DE ORO,INST SECUNDARIO AGUA DE ORO - AV BELGRANO S/N,3,3509,3511,951
3,COLON,31B,VILLA CERRO AZUL,LOCAL COMUNAL - VILLA CERRO AZUL,2,3512,3513,363
3,COLON,32,GENERAL PAZ,ESC PROV GRAL JOSE MARIA PAZ - BUENOS AIRES Y CORDOBA,6,3514,3519,1863
3,COLON,33,JESUS MARIA,PTE DOMINGO F SARMIENTO - CORDOBA (PARALEA A JUAN B JUSTO) 1.050,14,3520,3533,4802
3,COLON,33,JESUS MARIA,I.P.E.T.N° 69 - JESUS MARIA,13,3534,3546,4453
3,COLON,33,JESUS MARIA,ESC.DR. J.M.ESTRADA N° 221 - CATAMARCA Y ESTRADA,13,3547,3559,4446
3,COLON,33,JESUS MARIA,ESC.PROV.1ER.TTE.MORANDINI - CHILE -SAN JOSE OBRERO 222,12,3560,3571,4104
3,COLON,33,JESUS MARIA,ESC.PROVC.F.O. DE OCAMPO - AV. DR. FRANCISCO N. DE LAPRIDA 649 649,14,3572,3585,4788
3,COLON,33,JESUS MARIA,COL.NTA.SRA. DEL HUERTO - JESUS MARIA,7,3586,3592,2394
3,COLON,33,JESUS MARIA,ESC.N°21 GENDARMERIA NACIONAL - JESUS MARIA,10,3593,3602,3420
3,COLON,33A,COLONIA VICENTE AGÜERO,ESC PROV VICENTE AGUERO - LOTE XVII S/N,1,3603,3603,277
3,COLON,34,JUAREZ CELMAN,ESC PROV LEOPOLDO LUGONES - VILLA LOS LLANOS,9,3604,3612,3063
3,COLON,34,JUAREZ CELMAN,ESC.COMODORO R. SILIONI - AV. ACONCAGUA S/N,12,3613,3624,4080
3,COLON,34,JUAREZ CELMAN,ESC.ATAHUALPA YUPANQUI - BARRIO PARQUE NORTE,8,3625,3632,2720
3,COLON,35,MALVINAS ARGENTINAS,ESC.CAP.LUIS C.CANDELARIA - MALVINAS ARGENTINAS,10,3633,3642,3410
3,COLON,35,MALVINAS ARGENTINAS,ESC.MUNIC.CIUDAD DE M.ARGENTIN - MALVINAS ARGENTINAS,9,3643,3651,3069
3,COLON,35,MALVINAS ARGENTINAS,I.P.E.M. N° 24 - JUJUY ESQ. SARMIENTO S/N MALVINAS AR,16,3652,3667,5449
3,COLON,35A,MI GRANJA,JARDIN DE INF.CAP.CANDELARIA - VILLAFAÑE DEL VISO,3,3668,3670,915
3,COLON,36,LA PUERTA,ESC PROV SARGENTO CABRAL - PUBLICA S/N,2,3671,3672,347
3,COLON,37,RIO CEBALLOS,IPEM N° 352 - NICANOR CEBALLOS,13,3673,3685,4407
3,COLON,37,RIO CEBALLOS,ESC.PROV.M.FRAGUEIRO - AVENIDA SAN MARTIN 4.519,13,3686,3698,4407
3,COLON,37,RIO CEBALLOS,I.P.E.M.144-MARIANO MORENO - SALTA 191,10,3699,3708,3390
3,COLON,37,RIO CEBALLOS,INSTITUTO DEL ESPIRITU SANTO - AV. SAN MARTIN 5.109,12,3709,3720,4065
3,COLON,37,RIO CEBALLOS,ESC.CONSTANCIO C. VIGIL - 1 MAYO B° MOREYRA 112,6,3721,3726,2028
3,COLON,38,SALSIPUEDES,INST SECUNDARIO SALSIPUEDES - AV BELGRANO 178,8,3727,3734,2688
3,COLON,38,SALSIPUEDES,ESC.PROV. J.MALDONADO - DESIDERIO TORRES 360,12,3735,3746,4032
3,COLON,38,SALSIPUEDES,ESCUELA RECONQUISTA - CERRITO,6,3747,3752,2013
3,COLON,39,SANTA TERESA,ESC.PROV. FRAY M.ESQUIU - PUBLICA,1,3753,3753,63
3,COLON,40,UNQUILLO,INST.NTA.SRA.DE LAS MERCEDES - AZOPARDO 200,9,3754,3762,3105
3,COLON,40,UNQUILLO,ESC.PROV. D.V.SARSFIELD - SARMIENTO Y VELEZ SARSFIELD,8,3763,3770,2760
3,COLON,40,UNQUILLO,I.P.E.M. N° 23 - SPILIMBERGO 869,8,3771,3778,2760
3,COLON,40,UNQUILLO,I.P.E.M. N° 78 - COSTANERA LOS CIGARRALES B 750,14,3779,3792,4828
3,COLON,40,UNQUILLO,INST.PARROQ.NTA.SRA DE LOURDES - JUAN MILICH,10,3793,3802,3440
3,COLON,40A,MENDIOLAZA,ESC.PIAS DE MENDIOLAZA - RUTA PROVINCIAL INTERMUNICIPAL E 57,8,3803,3810,2744
3,COLON,40A,MENDIOLAZA,ESC.PROV. D.F.SARMIENTO - MALVINAS ARGENTINAS Y SARMIENTO,11,3811,3821,3773
3,COLON,40A,MENDIOLAZA,I.P.E.M.N° 317 - MENDIOLAZA,10,3822,3831,3420
3,COLON,41,VILLA ALLENDE,COLEGIO MARYLAND - GUEMES ESQ ALBERTI,10,3832,3841,3450
3,COLON,41,VILLA ALLENDE,ESC.PROV. J.DE SAN MARTIN - GOYCOECHEA 150,13,3842,3854,4485
3,COLON,41,VILLA ALLENDE,COLEGIO SAN JOSE - VILLA ALLENDE,12,3855,3866,4140
3,COLON,41,VILLA ALLENDE,INST GRAL S.MARTIN/17 DE AGOST - 25 DE MAYO ESQ. TABLADA,28,3867,3894,9655
3,COLON,41,VILLA ALLENDE,INSTITUTO NTA.SRA. DE LUJAN - AV.SAN MARTIN 1.070,10,3895,3904,3440
3,COLON,41,VILLA ALLENDE,IPEM 130 RAUL DEL LLANO - DERQUI 635,11,3905,3915,3784
3,COLON,41A,SALDAN,JARDIN NOGAL HISTORICO - 25 DE MAYO 109,2,3916,3917,676
3,COLON,41A,SALDAN,ESCUELA NOGAL HISTORICO - JOSE ACCASTELLI 252,13,3918,3930,4382
3,COLON,41A,SALDAN,ESC.DE COMERCIO J.M.PAZ - VELEZ SARSFIELD 647,14,3931,3944,4718
3,COLON,41A,SALDAN,ESCUELA DANDELION - 9 DE JULIO 362,3,3945,3947,1011
4,CRUZ DEL EJE,42,BAÑADO DE SOTO,ESCUELA PROV.M. MORENO - PUBLICA S/N,3,3948,3950,711
4,CRUZ DEL EJE,43,CANDELARIA,ESCUELA PROVINCIAL - CANDELARIA,1,3951,3951,51
4,CRUZ DEL EJE,43A,LAS CAÑADAS,ESC.PROV. CANTERAS IGUAZU - LAS CAÑADAS,1,3952,3952,193
4,CRUZ DEL EJE,43B,CRUZ DE CAÑA,ESC PROV JUAN B ALBERDI - PUBLICA S/N,2,3953,3954,227
4,CRUZ DEL EJE,44,CRUZ DEL EJE,IPEM N° 253 - ALEM ESQ DOMINGO MATEU,17,3955,3971,5831
4,CRUZ DEL EJE,44,CRUZ DEL EJE,ESC.PROV.D.F.SARMIENTO - IRIGOYEN 247,13,3972,3984,4459
4,CRUZ DEL EJE,44,CRUZ DEL EJE,ESC.E. BAVIO - PELLEGRINI 180,13,3985,3997,4459
4,CRUZ DEL EJE,44,CRUZ DEL EJE,ESCUELA NORMAL - SARMIENTO 1155,17,3998,4014,5821
4,CRUZ DEL EJE,44,CRUZ DEL EJE,IPEM 273 M. BELGRANO - PELLEGRINI 445,13,4015,4027,4446
4,CRUZ DEL EJE,44A,LAS PLAYAS,ESC.PROV.PCIA.DE LA RIOJA - RUTA 75,2,4028,4029,618
4,CRUZ DEL EJE,45,EL BRETE,ESC PROV MANUEL BELGRANO - PUBLICA S/N,4,4030,4033,1172
4,CRUZ DEL EJE,46,GUANACO MUERTO,ESC PROV GRAL SAN MARTIN - PUBLICA S/N,3,4034,4036,958
4,CRUZ DEL EJE,46B,ALTO DE LOS QUEBRACHOS,ESCUELA PROVINCIAL - ALTO DE LOS QUEBRACH,2,4037,4038,430
4,CRUZ DEL EJE,47,IGLESIA VIEJA,ESC PROV JOSE MARIA PAZ - PUBLICA S/N,1,4039,4039,71
4,CRUZ DEL EJE,48,LA HIGUERA,ESC PROV GRAL SAN MARTIN - RUTA PROVINCIAL N°15 S/N,2,4040,4041,579
4,CRUZ DEL EJE,49,LOS SAUCES,ESC.PROV.M.MORENO - LOS SAUCES,1,4042,4042,82
4,CRUZ DEL EJE,50,MEDIA NARANJA,ESCUELA M. GUEMES - MEDIA NARANJA,3,4043,4045,862
4,CRUZ DEL EJE,50A,LOS CHAÑARITOS,ESC DOMINGO F SARMIENTO - PUBLICA S/N,3,4046,4048,769
4,CRUZ DEL EJE,51,PASO VIEJO,I.P.E.A. N° 306 DR A SABATTINI -,3,4049,4051,978
4,CRUZ DEL EJE,51A,SANTA ANA,ESC.PROV.J.M.PAZ - SANTA ANA,1,4052,4052,86
4,CRUZ DEL EJE,52,PICHANAS,ESC.PROV.J.V.GONZALEZ - PUBLICA,1,4053,4053,159
4,CRUZ DEL EJE,53,SAN ANTONIO,ESC.PROV. BME. MITRE - PUBLICA,1,4054,4054,31
4,CRUZ DEL EJE,53A,LOS LEONES,ESC. R.S. DE CALDELARI - LOS LEONES,1,4055,4055,56
4,CRUZ DEL EJE,53B,EL ABRA,ESCUELA N°395(MANUEL LUCERO) - EL ABRA,1,4056,4056,45
4,CRUZ DEL EJE,54,SAN MARCOS SIERRAS,ESC PROV PTE ROQUE SAENZ PEÑA - LIBERTAD 1.043,7,4057,4063,2333
4,CRUZ DEL EJE,54A,CANTERAS QUILPO,ESC.PROV.M. BELGRANO - CANTERAS QUILPO,1,4064,4064,95
4,CRUZ DEL EJE,55,SERREZUELA,ESC.PROV.B.RIVADAVIA - AVDA. MALVINAS ARGENTINAS,8,4065,4072,2662
4,CRUZ DEL EJE,55A,LA BATEA,ESC.PROV.DEAN G.FUNES - LA BATEA,1,4073,4073,169
4,CRUZ DEL EJE,56,SOTO,ESC.PADRE B.DE LAS CASAS - JOSE IGNACIO PERALTA 249,8,4074,4081,2728
4,CRUZ DEL EJE,56,SOTO,INSTITUTO SANTO DOMINGO - SOTO,4,4082,4085,1364
4,CRUZ DEL EJE,56,SOTO,E.N.E.T. N°1 - JUAN BAUTISTA ALBERDI 2.200,5,4086,4090,1700
4,CRUZ DEL EJE,56,SOTO,ESC NICOLAS AVELLANEDA - DEAN FUNES ESQ CORRIENTES,4,4091,4094,1360
4,CRUZ DEL EJE,57,TUCLAME,ESC.PROV.J.J.CASTELLI - PUBLICA,4,4095,4098,1219
5,GENERAL ROCA,58,BRUZONE,ESC.PROV. J.J. PASO - MARIANO MORENO,1,4099,4099,240
5,GENERAL ROCA,59,BUCHARDO,ESC PROV JOSE MARIA PAZ - AV MANNY S/N,6,4100,4105,1803
5,GENERAL ROCA,60,DEL CAMPILLO,ESCUELA J.M.PAZ - JOSE MARIA PAZ   ENRIQUE COOK 444,7,4106,4112,2251
5,GENERAL ROCA,60,DEL CAMPILLO,I.P.E.M. N° 219 - DEL CAMPILLO,3,4113,4115,963
5,GENERAL ROCA,61,HUINCA RENANCO,ESC.PROV. D.F. SARMIENTO - PTE. JUAN D.PERON  VILLA TORROBA 75,10,4116,4125,3310
5,GENERAL ROCA,61,HUINCA RENANCO,ESC.PASO DE LOS ANDES - GARAY VILLA PACIFICO 121,5,4126,4130,1650
5,GENERAL ROCA,61,HUINCA RENANCO,COLEGIO NAC. L.V.MANSILLA - HUINCA RENANCO,8,4131,4138,2640
5,GENERAL ROCA,62,ITALO,ESC DR BENJAMIN DUPONT - LAVALLE S/N,4,4139,4142,1091
5,GENERAL ROCA,63,JOVITA,ESC.PROV.D.F. SARMIENTO - JOVITA,7,4143,4149,2307
5,GENERAL ROCA,63,JOVITA,I.P.E.M. N° 221 - JOVITA,6,4150,4155,1974
5,GENERAL ROCA,65,LECUEDER,ESC PROV MANUEL BELGRANO - PUBLICA S/N,1,4156,4156,18
5,GENERAL ROCA,66,MATTALDI,ESC.PROV. SAN LUIS - TUCUMAN 225,5,4157,4161,1633
5,GENERAL ROCA,67,ONAGOITY,ESC.PROV. V. MERCANTE - PUBLICA,1,4162,4162,67
5,GENERAL ROCA,68,PINCEN,ESC. ING.A.EBELOT - FELIPA ROSALES,1,4163,4163,254
5,GENERAL ROCA,69,RANQUELES,ESC.PROV.F.N.LAPRIDA - PUBLICA,1,4164,4164,51
5,GENERAL ROCA,70,VILLA HUIDOBRO,INST. DE LOS SAGRADOS CORAZONE - SANTA MARI JOSEFA ROSSELLO 250,8,4165,4172,2652
5,GENERAL ROCA,70,VILLA HUIDOBRO,ESC.PROV.M.BELGRANO - PASCO 327,7,4173,4179,2317
5,GENERAL ROCA,71,VILLA SARMIENTO,ESC.PROV. D.F.SARMIENTO - PUBLICA,1,4180,4180,308
5,GENERAL ROCA,72,VILLA VALERIA,ESC.PROV.J.CROTTO - VILLA VALERIA,8,4181,4188,2687
6,GRAL SAN MARTIN,73,ARROYO ALGODON,ESC.PROV. A.ARGENTINA - CORDOBA 301,5,4189,4193,1492
6,GRAL SAN MARTIN,74,ARROYO CABRAL,INST. SEC. COM. SAN JOSE - ARROYO CABRAL,5,4194,4198,1606
6,GRAL SAN MARTIN,74,ARROYO CABRAL,ESC.PROV.D.V.SARSFIELD - RIVADAVIA 410,4,4199,4202,1284
6,GRAL SAN MARTIN,75,AUSONIA,ESC.PROV.GRAL SAN MARTIN - 25 DE MAYO 551,3,4203,4205,946
6,GRAL SAN MARTIN,76,CHAZON,ESC PROV M R DE LA TORRE - DIESCISEIS 582,3,4206,4208,994
6,GRAL SAN MARTIN,77,ETRURIA,INSTITUTO SEC. GRAL PAZ - BV.SRMIENTO Y S.NICOLA 390,5,4209,4213,1646
6,GRAL SAN MARTIN,77,ETRURIA,ESC.PROV. 12 DE OCTUBRE - ETRURIA,6,4214,4219,1974
6,GRAL SAN MARTIN,78,LA LAGUNA,ESC ESTEBAN ECHEVERRIA - GENERAL PAZ 556,4,4220,4223,1355
6,GRAL SAN MARTIN,79,LA PLAYOSA,ESC.PROV. 25 DE MAYO - LA PLAYOSA,9,4224,4232,2848
6,GRAL SAN MARTIN,80,LUCA,ESC.PROV.J.V.GONZALEZ - 9 DE JULIO 350,2,4233,4234,588
6,GRAL SAN MARTIN,81,MOJARRAS,ESC.PROV. ISLAS MALVINAS - RUTA PROV N 158,1,4235,4235,68
6,GRAL SAN MARTIN,82,PALESTINA,ESC PROV CMTE L PIEDRABUENA - FELIPE LORENZATTI 875,2,4236,4237,539
6,GRAL SAN MARTIN,83,PASCO,ESC.PROV.D.F.SARMIENTO - PASCO,4,4238,4241,1195
6,GRAL SAN MARTIN,84,SANABRIA,ESC PROV JOSE DE SAN MARTIN - PUBLICA S/N,1,4242,4242,40
6,GRAL SAN MARTIN,86,SILVIO PELLICO,ESC.PROV.M.GUEMES - ANTONIO CONRERO 24,2,4243,4244,630
6,GRAL SAN MARTIN,87,TICINO,ESC. A. CAPDEVILA - TICINO,6,4245,4250,1998
6,GRAL SAN MARTIN,88,TIO PUJIO,ESC.R.DE ESCALADA - TIO PUJIO,12,4251,4262,3121
6,GRAL SAN MARTIN,89,VILLA MARIA,ESCUELA J.MARMOL - NAC. UNIDAS 385,10,4263,4272,3450
6,GRAL SAN MARTIN,89,VILLA MARIA,ESC.DR. J.BIANCO - BELGRANO 302,12,4273,4284,4140
6,GRAL SAN MARTIN,89,VILLA MARIA,ESC.REP.DEL PARAGUAY - CHILE 565,10,4285,4294,3450
6,GRAL SAN MARTIN,89,VILLA MARIA,INSTITUTO DEL ROSARIO - BV.ALVEAR 68,31,4295,4325,10695
6,GRAL SAN MARTIN,89,VILLA MARIA,INST.LA SANTISIMA TRINIDAD - SARSFIELD 1.072,27,4326,4352,9315
6,GRAL SAN MARTIN,89,VILLA MARIA,ESC.N.AVELLANEDA - BS.AS.E INT.MACIEL,14,4353,4366,4830
6,GRAL SAN MARTIN,89,VILLA MARIA,ESC.N.V.MERCANTE - SOBRAL 378,30,4367,4396,10337
6,GRAL SAN MARTIN,89,VILLA MARIA,IPEM N°275 EX COLEGIO NACIONAL - S.DEL ESTERO 618,15,4397,4411,5160
6,GRAL SAN MARTIN,89,VILLA MARIA,ESC.COM.A.OCAMPO - CATAMARCA 650,12,4412,4423,4128
6,GRAL SAN MARTIN,89,VILLA MARIA,I.P.E.T. N° 2 - J.MULLER 651,14,4424,4437,4816
6,GRAL SAN MARTIN,89,VILLA MARIA,ESC.J.INGENIEROS - SANTA FE 1.271,13,4438,4450,4472
6,GRAL SAN MARTIN,89,VILLA MARIA,CENMA N° 96 - SANTA FE 643,8,4451,4458,2752
6,GRAL SAN MARTIN,89,VILLA MARIA,INSTITUTO SAN ANTONIO - RUCCI 141,10,4459,4468,3440
6,GRAL SAN MARTIN,90,VILLA NUEVA,ESC.BME.MITRE - MITRE 1147,8,4469,4476,2752
6,GRAL SAN MARTIN,90,VILLA NUEVA,IPEM N° 322 - LIMA Y RIVADAVIA,10,4477,4486,3440
6,GRAL SAN MARTIN,90,VILLA NUEVA,ESCUELA PABLO VI - VILLA NUEVA,6,4487,4492,2064
6,GRAL SAN MARTIN,90,VILLA NUEVA,INSTITUTO INMAC.CONCEPCION - CABANILLAS 400,13,4493,4505,4472
6,GRAL SAN MARTIN,90,VILLA NUEVA,ESC.M.BELGRANO - BELGRANO 662,11,4506,4516,3773
6,GRAL SAN MARTIN,90,VILLA NUEVA,ESC.REP.DE BOLIVIA - D.FUNES 1250,3,4517,4519,1029
7,ISCHILIN,91,AVELLANEDA,ESC.PROV.FRAY M. ESQUIU - PUBLICA S/N,2,4520,4521,485
7,ISCHILIN,91A,CANTERAS,ESC.PROV.J.V.RECLA - CANTERAS,1,4522,4522,23
7,ISCHILIN,91B,LOS POZOS,ESC LIB GRAL SAN MARTIN - PUBLICA S/N,1,4523,4523,118
7,ISCHILIN,91C,VILLA GUTIERREZ,ESC.PROV.M.MARTINEZ DE SUAREZ - PUBLICA,1,4524,4524,279
7,ISCHILIN,92,CAÑADA DE RIO PINTO,ESC.PROV.H.VIEYTES - PUBLICA,2,4525,4526,398
7,ISCHILIN,93,COPACABANA,ESC JUAN M DE PUEYRREDON - PUBLICA S/N,2,4527,4528,347
7,ISCHILIN,94,CHUÑA,ESC PROV GRAL M GUEMES - PUBLICA S/N,2,4529,4530,593
7,ISCHILIN,95,DEAN FUNES,ESC.PROV.GRAL SAN MARTIN - DEAN FUNES,9,4531,4539,3060
7,ISCHILIN,95,DEAN FUNES,ESC.M.J.G.DE BELGRANO - JERONIMO L DE CABRERA L ALGARROBOS 451,10,4540,4549,3400
7,ISCHILIN,95,DEAN FUNES,ESC.PEDRO N.ARIAS - CORDOBA 87,11,4550,4560,3740
7,ISCHILIN,95,DEAN FUNES,ESC.PROV. M.MORENO - DORREGO   OBRAS SANITARIAS 326,10,4561,4570,3400
7,ISCHILIN,95,DEAN FUNES,ESC.A.M.SOBRAL - SANTIAGO DEL ESTERO Y LAS HERAS,9,4571,4579,3057
7,ISCHILIN,95,DEAN FUNES,ESC.AMANDA SUAREZ CORDOBA - SANTA ROSA ESQ. AMADEO SABATTINI,5,4580,4584,1695
7,ISCHILIN,96A,OLIVARES SAN NICOLAS,ESC.PROV.GUIDO SPANO - PUBLICA,2,4585,4586,571
7,ISCHILIN,97,ISCHILIN,ESCUELA FERNANDO FADER - PUBLICA S/N,1,4587,4587,76
7,ISCHILIN,98,JAIME PETER,ESCUELA FRAY GUILLERMO BUTLER - PUBLICA S/N,1,4588,4588,55
7,ISCHILIN,99,QUILINO ESTACION,ESC.PROVINCIA DE BS.AIRES - MARIANO MORENO 220,8,4589,4596,2585
7,ISCHILIN,99,QUILINO ESTACION,ESC.PROV.M.BELGRANO - QUILINO ESTACION,5,4597,4601,1615
7,ISCHILIN,100,QUILINO VILLA,ESC.PROV.D.V.SARSFIELD - VELEZ SARSFIELD,3,4602,4604,983
7,ISCHILIN,101,TOYOS,ESC PROV JOAQUIN V GONZALEZ - PUBLICA S/N,1,4605,4605,82
8,JUAREZ CELMAN,102,ALEJANDRO,ESC.EL GRAN CAPITAN - SARMIENTO 25,8,4606,4613,2688
8,JUAREZ CELMAN,102,ALEJANDRO,ESC.MISIONEROS SALESIANOS - ALEJANDRO,7,4614,4620,2352
8,JUAREZ CELMAN,103,ASSUNTA,ESC.PROV.D.F.SARMIENTO - PUBLICA S/N,1,4621,4621,74
8,JUAREZ CELMAN,105,BENGOLEA,ESC.SEÑOR DE LA BUENA MUERTE - BENGOLEA,3,4622,4624,971
8,JUAREZ CELMAN,106,CABRERA,INST. G.L.DE CABRERA - CABRERA,9,4625,4633,3015
8,JUAREZ CELMAN,106,CABRERA,ESC.PROV.J.M.PAZ - CABRERA,8,4634,4641,2672
8,JUAREZ CELMAN,106,CABRERA,ESC.FRAY PIO BENTIVOGLIO - MAIPU   BARRIO ARGENTINO 962,7,4642,4648,2338
8,JUAREZ CELMAN,106,CABRERA,ESC.PROV.E.F.OLMOS - 20 DE SEPTIEMBRE 584,7,4649,4655,2338
8,JUAREZ CELMAN,107,CARNERILLO,ESC.TTE. 1°M.C.ASUA - CARNERILLO,6,4656,4661,1884
8,JUAREZ CELMAN,108,CHARRAS,ESC TTE CNEL J DUATE ARDOY - SARMIENTO 182,4,4662,4665,1041
8,JUAREZ CELMAN,109,DEHEZA,INSTITUTO SEC. 25 DE MAYO - DEHEZA,6,4666,4671,2040
8,JUAREZ CELMAN,109,DEHEZA,ESC.PROV.GRAL SAN MARTIN - BV SAN MARTIN 251,12,4672,4683,4079
8,JUAREZ CELMAN,109,DEHEZA,INST.TEC.ADRIAN P. URQUIA - GENERAL DEHEZA,10,4684,4693,3390
8,JUAREZ CELMAN,110,EL RASTREADOR,ESC CARLOS MARIA DE ALVEAR - PUBLICA S/N,1,4694,4694,60
8,JUAREZ CELMAN,110A,PACHECO DE MELO,ESC.PROV.M.BELGRANO - 12 DE OCTUBRE,1,4695,4695,72
8,JUAREZ CELMAN,111,HUANCHILLA,ESC PROV DOMINGO F SARMIENTO - CARLOS ALBERTO MAYOL S/N,4,4696,4699,1212
8,JUAREZ CELMAN,112,LA CARLOTA,INST.NTA.M.DE LAS MERCEDES - 9 DE JULIO 271,8,4700,4707,2744
8,JUAREZ CELMAN,112,LA CARLOTA,ESC.NAC.DE COMERCIO - V.SARSFIELD 651,12,4708,4719,4114
8,JUAREZ CELMAN,112,LA CARLOTA,ESC.FORTIN HEROICO - ACOSTA 673,12,4720,4731,4104
8,JUAREZ CELMAN,113,LOS CISNES,ESC DOMINGO F SARMIENTO - SRITA BERNARDINA BAIGORRI 229,2,4732,4733,673
8,JUAREZ CELMAN,114,OLAETA,ESCUELA PROV.FRENCH Y BERUTTI - 25 DE MAYO 135,2,4734,4735,644
8,JUAREZ CELMAN,116,REDUCCION,ESC.CAP. F.D.ZARCO - MANUEL DE LA LASTRA 623,5,4736,4740,1425
8,JUAREZ CELMAN,116A,PASO DEL DURAZNO,ESC.PROV.MARTIN DE ALVA - PASO DEL DURAZNO,1,4741,4741,110
8,JUAREZ CELMAN,117,SANTA EUFEMIA,INSTITUTO DR.M. BELGRANO - SANTA EUFEMIA,7,4742,4748,2122
8,JUAREZ CELMAN,118,UCACHA,ESC.PROV.J.B.ALBERDI - UCACHA,8,4749,4756,2588
8,JUAREZ CELMAN,118,UCACHA,ESC.MARTIN GUERRICO - UCACHA,7,4757,4763,2261
9,MARCOS JUAREZ,119,ALEJO LEDESMA,INSTITUTO SEC. V.SARSFIELD - LEANDRO N ALEM,4,4764,4767,1244
9,MARCOS JUAREZ,119,ALEJO LEDESMA,ESCUELA N.AVELLANEDA - HIPOLITO YRIGOYEN,2,4768,4769,622
9,MARCOS JUAREZ,119,ALEJO LEDESMA,ESC.PROV.D.F.SARMIENTO - LEANDRO N ALEM,4,4770,4773,1240
9,MARCOS JUAREZ,120,ARIAS,ESC.R.ESCALADA DE SAN MARTIN - AV. ESPAÑA 799,10,4774,4783,3440
9,MARCOS JUAREZ,120,ARIAS,ESC.PROV.SGTO.CABRAL - INTENDENTE MELQUIOT 922,9,4784,4792,3093
9,MARCOS JUAREZ,121,BALDISSERA,ESC JOSE MARIA PAZ - SARMIENTO,6,4793,4798,1992
9,MARCOS JUAREZ,122,BARGE,ESC PROV DOMINGO F SARMIENTO - PUBLICA S/N,1,4799,4799,228
9,MARCOS JUAREZ,123,CAMILO ALDAO,IPEM N°151 J URBIZU - BV JOSE M ALDAO 1.160,7,4800,4806,2235
9,MARCOS JUAREZ,123,CAMILO ALDAO,ESC JUAN BAUTISTA ALBERDI - SAN MARTIN,6,4807,4812,1914
9,MARCOS JUAREZ,124,CAVANAGH,ESC.SEC.TOMAS THOMAS - CORDOBA 138,4,4813,4816,1056
9,MARCOS JUAREZ,125,CORRAL DE BUSTOS,INST. SUP. JOSE MANUEL ESTRADA - SANTA FE 665,9,4817,4825,2997
9,MARCOS JUAREZ,125,CORRAL DE BUSTOS,ESC R ESCALADA DE SAN MARTIN - CORRAL DE BUSTOS,7,4826,4832,2331
9,MARCOS JUAREZ,125,CORRAL DE BUSTOS,COLEGIO JUAN XXIII - CORRAL DE BUSTOS,6,4833,4838,1998
9,MARCOS JUAREZ,125,CORRAL DE BUSTOS,ESC NOR SUP MAESTROS ARGENTINO - CORRAL DE BUSTOS,5,4839,4843,1665
9,MARCOS JUAREZ,126,CRUZ ALTA,COLEGIO SANTA JUANA DE ARCO - CRUZ ALTA,7,4844,4850,2323
9,MARCOS JUAREZ,126,CRUZ ALTA,IPEM N° 276 - CRUZ ALTA,7,4851,4857,2317
9,MARCOS JUAREZ,126,CRUZ ALTA,ESC LIB GRAL SAN MARTIN - RIVADAVIA 1252 B°RIVADAVIA,5,4858,4862,1655
9,MARCOS JUAREZ,127,GUATIMOZIN,ESC DALMACIO VELEZ SARSFIELD - AV CORDOBA 324,7,4863,4869,2147
9,MARCOS JUAREZ,128,INRIVILLE,INST JOSE MARIA PAZ - INRIVILLE,5,4870,4874,1585
9,MARCOS JUAREZ,128,INRIVILLE,ESC MARIANO MORENO - INRIVILLE,5,4875,4879,1585
9,MARCOS JUAREZ,128,INRIVILLE,ESC.PROV.J.J.URQUIZA - INRIVILLE,1,4880,4880,317
9,MARCOS JUAREZ,128A,SALADILLO,ESC.PROV.PAULA ALBARRACIN - AV 24 DE SEPTIEMBRE,1,4881,4881,136
9,MARCOS JUAREZ,129,ISLA VERDE,INST SEC ISLA VERDE - LIBERTAD 446,12,4882,4893,4118
9,MARCOS JUAREZ,130,LA ITALIANA,ESC.PROV.GRAL SAN MARTIN - ISLAS MALVINAS,2,4894,4895,639
9,MARCOS JUAREZ,131,LEONES,ESC JOAQUIN V GONZALEZ - RAMON INFANTE 422,9,4896,4904,3006
9,MARCOS JUAREZ,131,LEONES,IPEM N°256-LIB GRAL SAN MARTIN - LEONES,7,4905,4911,2332
9,MARCOS JUAREZ,131,LEONES,ESC DE COMERCIO Y BACHILLERATO - LEONES,12,4912,4923,3996
9,MARCOS JUAREZ,131A,VILLA ELISA,ESCUELA VICTORIA OCAMPO - VILLA ELISA,1,4924,4924,26
9,MARCOS JUAREZ,132,LOS SURGENTES,ESC GENERAL SAN MARTIN - LOS SURGENTES,8,4925,4932,2509
9,MARCOS JUAREZ,133,MARCOS JUAREZ,COLEGIO SAGRADO CORAZON - LARDIZABAL 545,13,4933,4945,4433
9,MARCOS JUAREZ,133,MARCOS JUAREZ,ESC NORMAL SUP DR M BELGRANO - R SAENZ PEÑA Y S DEL ESTERO,17,4946,4962,5796
9,MARCOS JUAREZ,133,MARCOS JUAREZ,ESC BERNARDINO RIVADAVIA - SAN MARTIN 694,11,4963,4973,3740
9,MARCOS JUAREZ,133,MARCOS JUAREZ,IPEM N°51 NICOLAS AVELLANEDA - MARCOS JUAREZ,12,4974,4985,4080
9,MARCOS JUAREZ,133,MARCOS JUAREZ,ESC MARIANO MORENO - SAN JUAN 1090 SUR,8,4986,4993,2720
9,MARCOS JUAREZ,133,MARCOS JUAREZ,ESCUELA BARTOLOME MITRE - HIPOLITO YRIGOYEN 1409 NOROESTE,7,4994,5000,2380
9,MARCOS JUAREZ,134,MONTE BUEY,ESC JOSE MANUEL ESTRADA - MONTE BUEY,8,5001,5008,2721
9,MARCOS JUAREZ,134,MONTE BUEY,ESC MANUEL BELGRANO - MONTE BUEY,6,5009,5014,2040
9,MARCOS JUAREZ,134,MONTE BUEY,INST.SEC.GRAL J.M.PAZ - MONTE BUEY,2,5015,5016,680
9,MARCOS JUAREZ,135,CAP.B.O HIGGINS,ESC.PROV.GRAL SAN MARTIN - AV ITALIA 448,1,5017,5017,320
9,MARCOS JUAREZ,136,ROCA,ESC ROQUE SAENZ PEÑA - ROCA,5,5018,5022,1618
9,MARCOS JUAREZ,136,ROCA,ESC 9 DE JULIO - ALSINA 517 SUR,3,5023,5025,969
9,MARCOS JUAREZ,137,SAIRA,INSTITUTO MANUEL BELGRANO - SAIRA,3,5026,5028,755
10,MINAS,138,CIENAGA DEL CORO,ESC PROV COMTE ROSENDO LEAL - CESAR MANUEL VERA S/N,3,5029,5031,926
10,MINAS,138A,RUMIACO,ESC MIGUEL DE AZCUENAGA - RUMIACO,1,5032,5032,27
10,MINAS,138B,RUMIHUASI,ESC.PROV.FRAY M.ESQUIU - PUBLICA,1,5033,5033,101
10,MINAS,138C,ESTANCIA DE GUADALUPE,ESC PROV NIÑAS DE AYOHUMA - PUBLICA S/N,2,5034,5035,429
10,MINAS,138D,TOSNO,ESC.PROV.MONS.R. LEAL - PUBLICA,1,5036,5036,186
10,MINAS,139,GUASAPAMPA,LOCAL COMUNAL,1,5037,5037,290
10,MINAS,139A,AGUA DE RAMON,ESC.PROV.R.VERA PEÑALOZA - AGUA DE RAMON,1,5038,5038,89
10,MINAS,139B,LA PLAYA,ESC PROV GRAJ J DE SAN MARTIN - PUBLICA S/N,1,5039,5039,237
10,MINAS,140,LA ARGENTINA,ESC PROV GREGORIA PEREZ - PUBLICA S/N,1,5040,5040,216
10,MINAS,140A,OJO DE AGUA DE TOTOX,ESC MARTIN MIGUEL DE GUEMES - OJO DE AGUA DE TOTOX,1,5041,5041,89
10,MINAS,141,PIEDRITA BLANCA,ESC PRIMARIA JORGE LUIS BORGES - PIEDRITA BLANCA,1,5042,5042,61
10,MINAS,141A,EL CHACHO,ESC PROV ANGEL V PEÑALOZA - PUBLICA S/N,1,5043,5043,158
10,MINAS,142,SAN CARLOS,ESC.SEC.J.L.DE CABRERA - RIVADAVIA E IRIGOYEN,6,5044,5049,2028
10,MINAS,142A,TALAINI,ESC.PROV.J.J.CASTELLI. - PUBLICA,1,5050,5050,152
11,POCHO,144,CHANCANI,ESC PROV MARIANO MORENO - PUBLICA S/N,3,5051,5053,1010
11,POCHO,144A,LAS JARILLAS,ESC.PROV.L.LUGONES - PUBLICA,1,5054,5054,93
11,POCHO,144B,EL MEDANITO,ESC R ESCALADA DE SAN MARTIN - EL MEDANITO,1,5055,5055,64
11,POCHO,145,POCHO,ESC.PROV.D.FRENCH - PUBLICA,2,5056,5057,499
11,POCHO,145A,LAS PALMAS,ESCUELA N°157 - LAS PALMAS,1,5058,5058,254
11,POCHO,146,SALSACATE,ESC GENERAL JOSE DE SAN MARTIN - AV CURA BROCHERO 150,6,5059,5064,1978
11,POCHO,146A,TALA CAÑADA,ESC.PROV.M.BELGRANO - TALA CAÑADA,1,5065,5065,283
11,POCHO,146B,SAN JERONIMO,ESC.PROV. E.ECHEVERRIA - SAN JERONIMO,1,5066,5066,290
11,POCHO,146C,LOS TALARES,ESC ROQUE SAENZ PEÑA - LOS TALARES,1,5067,5067,141
12,PUNILLA,147,BIALET MASSE,INST SERVILIANO DIAZ - SAN MARTIN 675,5,5068,5072,1635
12,PUNILLA,147,BIALET MASSE,INST NTA SRA DEL ROSARIO - BIALET MASSE,5,5073,5077,1635
12,PUNILLA,147,BIALET MASSE,ESC DR BIALET MASSE - ROQUE SAENZ PEÑA 91,7,5078,5084,2284
12,PUNILLA,147A,SAN ROQUE,ESC HOGAR ALBERTO MAGGI - CEFERINO NAMUNCURA 62,4,5085,5088,1103
12,PUNILLA,147B,VILLA PARQUE SIQUIMAN,ESC DR JERONIMO J DEL BARCO - VILLA PARQUE SIQUIMAN,6,5089,5094,1746
12,PUNILLA,148,CAPILLA DEL MONTE,ESC GRAL JOSE DE SAN MARTIN - SARMIENTO 380,8,5095,5102,2760
12,PUNILLA,148,CAPILLA DEL MONTE,IPEM N° 279 - HIPOLITO YRIGOYEN 450,12,5103,5114,4140
12,PUNILLA,148,CAPILLA DEL MONTE,ESC ESP JUAN MANUEL FERNANDEZ - AV PUEYRREDON 131,10,5115,5124,3440
12,PUNILLA,149,CASA GRANDE,ESC GRAL JOSE DE SAN MARTIN - RUTA NACIONAL N°38,2,5125,5126,643
12,PUNILLA,150,COSQUIN,COLEGIO PARROQUIAL PIO XII - OBISPO BUSTOS 816,11,5127,5137,3742
12,PUNILLA,150,COSQUIN,IPEM N°60 M MORENO(EX IPET 13) - PALEMON CARRANZA 1085,9,5138,5146,3060
12,PUNILLA,150,COSQUIN,IPEM N°157-PTE SARMIENTO - P CARRANZA 940,8,5147,5154,2720
12,PUNILLA,150,COSQUIN,ESC NORMAL SUP R SAENZ PEÑA - SAN MARTIN 394,8,5155,5162,2720
12,PUNILLA,150,COSQUIN,ESC TTE GRAL JULIO A ROCA - SAN MARTIN Y SARMIENTO S/N,13,5163,5175,4420
12,PUNILLA,150,COSQUIN,ESC ESP DR J REYES CONTRERAS - MONS DE ANDREA S/N B°SANTA TERESITA,7,5176,5182,2380
12,PUNILLA,151,CHARBONIER,ESC P ALBARRACIN DE SARMIENTO - PUBLICA S/N,2,5183,5184,658
12,PUNILLA,152,HUERTA GRANDE,ESC BERNARDINO RIVADAVIA - HUERTA GRANDE,8,5185,5192,2662
12,PUNILLA,152,HUERTA GRANDE,I.P.E.M N° 200 - ARRABARRENA ESQ PROV UNIDAS S/N,9,5193,5201,2988
12,PUNILLA,152A,VILLA GIARDINO,IPEM N° 339 - LOS COCOS ESQ PEPERINA,6,5202,5207,2000
12,PUNILLA,152A,VILLA GIARDINO,ESC ESTEBAN ECHEVERRIA - CHILE S/N B°INDEPENDENCIA,5,5208,5212,1665
12,PUNILLA,152A,VILLA GIARDINO,COL JUANA MICONO DE GIARDIN - AV SAN MARTIN 762,4,5213,5216,1332
12,PUNILLA,153,LA CUMBRE,ESC M E H DE GONZALEZ ELIZALDE - RIO NEGRO S/N B°ARGENTINO,6,5217,5222,2014
12,PUNILLA,153,LA CUMBRE,INSTITUTO GRAL SAN MARTIN - 9 DE JULIO 564 B°GOLF,8,5223,5230,2680
12,PUNILLA,153,LA CUMBRE,ESC JOSEFA MARIA BUSTOS - ALBERDI 277,7,5231,5237,2345
12,PUNILLA,154,LA FALDA,ESC JOSE MARIA PAZ - HIPOLITO YRIGOYEN 431 B°SAN JORGE,7,5238,5244,2366
12,PUNILLA,154,LA FALDA,IPEM N°142 JOAQUIN V GONZALEZ - SAN GERONIMO Y LAS AMERICAS S/N,11,5245,5255,3718
12,PUNILLA,154,LA FALDA,ESC MATEO J MOLINA - AV EDEN 445,10,5256,5265,3380
12,PUNILLA,154,LA FALDA,ESC NICOLAS AVELLANEDA - PROGRESO 399 B°SANTA ROSA,7,5266,5272,2362
12,PUNILLA,154,LA FALDA,ESC AERONAUTICA ARGENTINA - OCAMPO Y ROMAN DEHEZA S/N-LA LOMITA,6,5273,5278,2022
12,PUNILLA,155,SAN ESTEBAN,ESC INES MOYANO DE MOLINA - SAN ESTEBAN,3,5279,5281,753
12,PUNILLA,155A,LOS COCOS,ESC DRA CECILIA GRIERSON - LOS COCOS,3,5282,5284,1022
12,PUNILLA,156,VILLA CARLOS PAZ,ESC CARLOS NICANDRO PAZ - SAN MARTIN 255,17,5285,5301,5865
12,PUNILLA,156,VILLA CARLOS PAZ,ESC PRESIDENTE SARMIENTO - LOS GIGANTES S/N-B°M MUÑOZ,12,5302,5313,4140
12,PUNILLA,156,VILLA CARLOS PAZ,ESC ISLA DE LOS ESTADOS - LOS CEIBOS S/N B°LA QUINTA,10,5314,5323,3450
12,PUNILLA,156,VILLA CARLOS PAZ,INST ALFONSINA STORNI(EX IESS) - SOLIS 283 B° VILLA DOMINGUEZ,21,5324,5344,7245
12,PUNILLA,156,VILLA CARLOS PAZ,INST BERNARDO D'ELIA - ASUNCION B°LA QUINTA 440,15,5345,5359,5168
12,PUNILLA,156,VILLA CARLOS PAZ,INST R ESCALADA DE SAN MARTIN - ESTRADA Y ANTARTIDA,16,5360,5375,5504
12,PUNILLA,156,VILLA CARLOS PAZ,INST INDUSTRIAL CRISTO OBRERO - FLORENCIO SANCHEZ S/N-B°LAS MALVINAS,10,5376,5385,3440
12,PUNILLA,156,VILLA CARLOS PAZ,PRIMARIO JOSE DE SAN MARTIN - AMEGHINO Y BALCARCE,8,5386,5393,2752
12,PUNILLA,156,VILLA CARLOS PAZ,IPEM N° 365-DR RENE FAVALORO - GOBERNADOR ALVAREZ 131,10,5394,5403,3440
12,PUNILLA,156,VILLA CARLOS PAZ,INST BILINGUE DANTE ALIGHIERI - ALFONSINA STORNI Y LOS ALERCES,17,5404,5420,5848
12,PUNILLA,156,VILLA CARLOS PAZ,ESC RICARDO BERNABE FERNANDEZ - LAS MARGARITAS 255-VA INDEPENDENCIA,8,5421,5428,2752
12,PUNILLA,156,VILLA CARLOS PAZ,ESC JOSE A ALVAREZ CONDARCO - IGUALDAD 199 B°SAN IGNACIO,6,5429,5434,2064
12,PUNILLA,156,VILLA CARLOS PAZ,COLEGIO COSTA AZUL - HUARPES Y COMECHINGONES-B°COSTA AZUL,9,5435,5443,3096
12,PUNILLA,156A,YCHO CRUZ,ESC MERCEDES S M DE BALCARCE - GENERAL SAN MARTIN S/N,5,5444,5448,1620
12,PUNILLA,156B,CUESTA BLANCA,LOCAL COMUNAL - CUESTA BLANCA,2,5449,5450,425
12,PUNILLA,156C,MAYU SUMAJ,EDIFICIO COMUNAL - MAYU SUMAJ,4,5451,5454,1115
12,PUNILLA,156D,SAN ANTONIO DE ARREDONDO,ESC JUAN JOSE PASO - RUTA PROV. 14-KM.43 CENTRO,6,5455,5460,2066
12,PUNILLA,156D,SAN ANTONIO DE ARREDONDO,IPEM 348 - RUTA 14 Y CNO A LAS JARILLAS,7,5461,5467,2408
12,PUNILLA,156E,TALA HUASI,EDIFICIO COMUNAL - TALA HUASI,1,5468,5468,235
12,PUNILLA,157,SANTA MARIA,COLEGIO SAN ROQUE - LAVALLE 2730 VILLA BUSTOS,6,5469,5474,2028
12,PUNILLA,157,SANTA MARIA,ESC BENJAMIN MATIENZO - DR.MIGUEL A. VOCOS S/N TILLARD,4,5475,5478,1349
12,PUNILLA,157,SANTA MARIA,ESC JUAN BAUTISTA AZOPARDO - SARMIENTO 59 VILLA BUSTOS,7,5479,5485,2359
12,PUNILLA,157,SANTA MARIA,INST. SEC. ORIENTACION REGIONA - VILLA BUSTOS,7,5486,5492,2359
12,PUNILLA,158,TANTI,ESC DOMINGO FAUSTINO SARMIENTO - MARIANO MORENO 597 B°VILLA NUEVA,9,5493,5501,2966
12,PUNILLA,158,TANTI,IPEM N°84 J VOCOS LESCANO - SAN FRANCISCO 33 LA ESTANCIA,9,5502,5510,2961
12,PUNILLA,158A,CABALANGO,ESC.PROV.D. FRENCH - CALLE 10,2,5511,5512,440
12,PUNILLA,158B,ESTANCIA VIEJA,LOCAL COMUNAL - ESTANCIA VIEJA,4,5513,5516,1038
12,PUNILLA,158C,VILLA SANTA CRUZ DEL LAGO,IPEM N° 332 - LOS TALAS ESQ. LAS ROSAS,8,5517,5524,2540
12,PUNILLA,159,VALLE HERMOSO,IPEM N° 335 - GOBERNADOR NUÑEZ 73,8,5525,5532,2712
12,PUNILLA,159,VALLE HERMOSO,INST.NTA.SRA. DEL CALVARIO - SAN MARTIN 12,8,5533,5540,2704
13,RIO CUARTO,160,ACHIRAS,ESC DOMINGO FAUSTINO SARMIENTO - ACHIRAS,8,5541,5548,2611
13,RIO CUARTO,160A,LA CAROLINA,ESC PROV DOMINGO F SARMIENTO - PUBLICA S/N,1,5549,5549,243
13,RIO CUARTO,161,ADELIA MARIA,INSTITUTO ADELIA MARIA - AV SAN MARTIN 1050 CENTRO,11,5550,5560,3674
13,RIO CUARTO,161,ADELIA MARIA,ESC GENERAL SAN MARTIN - SARMIENTO 98 CENTRO,8,5561,5568,2667
13,RIO CUARTO,162,ALCIRA,ESC JOSE MARIA PAZ - GRAL ROCA 643 CENTRO,7,5569,5575,2412
13,RIO CUARTO,162,ALCIRA,ESC PERITO FRANCISCO MORENO - DEAN FUNES Y HEROES ANONIMOS S/N,9,5576,5584,3096
13,RIO CUARTO,163,ALPA CORRAL,IPEM N° 119 NESTOR ZARAZAGA - PUBLICA S/N,4,5585,5588,1215
13,RIO CUARTO,164,BAIGORRIA,ESC PROV BERNARDINO RIVADAVIA - VELEZ SARSFIELD 50,6,5589,5594,1757
13,RIO CUARTO,165,BANDA NORTE,ANGELES CUSTODIOS/SAGRADA FLIA - ISABEL LA CATOLICA Y E JENNER S/N,12,5595,5606,4104
13,RIO CUARTO,165,BANDA NORTE,ESC DR ADOLFO ALSINA - AVENIDA GARIBALDI 740,11,5607,5617,3761
13,RIO CUARTO,165,BANDA NORTE,MERC DEL NIÑO JESUS/S FCO ASIS - VICTOR HUGO 885,18,5618,5635,6138
13,RIO CUARTO,165,BANDA NORTE,INST SUP RAMON MENENDEZ PIDAL - AV JOSE GARIBALDI 50,12,5636,5647,4092
13,RIO CUARTO,165,BANDA NORTE,ESC PROVINCIA SANTA CRUZ - SANTA FE ESQ URUGUAY S/N,13,5648,5660,4433
13,RIO CUARTO,165,BANDA NORTE,ESC REPUBLICA DEL URUGUAY - SAN LUIS 342,6,5661,5666,2046
13,RIO CUARTO,165,BANDA NORTE,IPEM N°95 M SANCHEZ DE THOMPSO - MANCO CAPAC 50,14,5667,5680,4774
13,RIO CUARTO,165,BANDA NORTE,CNMA 24-ANEXO PCIA STA CRUZ - EL SALVADOR 840 B° BALACCO,2,5681,5682,682
13,RIO CUARTO,166,BERROTARAN,ESC VICTOR MERCANTE - FRAY MAMERTO ESQUIU 25,8,5683,5690,2673
13,RIO CUARTO,166,BERROTARAN,INSTITUTO PARROQ.BERROTARAN - AQUINO ARGUELLO ARDILES 203,11,5691,5701,3674
13,RIO CUARTO,167,BULNES,ESC.FRAY M.ALVAREZ - SARMIENTO 187,4,5702,5705,1083
13,RIO CUARTO,168,CHAJAN,ESC PROV GRAL J DE SAN MARTIN - BV CORDOBA S/N,3,5706,5708,827
13,RIO CUARTO,169,CHUCUL,ESC SUBTTE RODOLFO H BERDINA - AV SAN MARTIN S/N,2,5709,5710,413
13,RIO CUARTO,170,ELENA,INST SEC LA ASUNCION DE MARIA - PASAJE CURA BROCHERO 189,5,5711,5715,1593
13,RIO CUARTO,170,ELENA,ESC RICARDO GUTIERREZ - ELENA,4,5716,5719,1272
13,RIO CUARTO,171,ESPINILLO,ESC PROV JOSE DE SAN MARTIN - RUTA NACIONAL 36 KM 614 S/N,1,5720,5720,153
13,RIO CUARTO,172,HOLMBERG,ESC.PROV.C.SAAVEDRA - HOLMBERG,6,5721,5726,2019
13,RIO CUARTO,172,HOLMBERG,ESC.S.R.DE ZAVALIA - HOLMBERG,5,5727,5731,1680
13,RIO CUARTO,172,HOLMBERG,IPEM N° 125 R SCALABRINI ORTIZ,3,5732,5734,1008
13,RIO CUARTO,173,LA ARGENTINA,ESC JOSE DE SAN MARTIN - CALLE PUBLICA,1,5735,5735,17
13,RIO CUARTO,174,LA CAUTIVA,ESC PROV JOSE DE SAN MARTIN - SAN MARTIN S/N,3,5736,5738,736
13,RIO CUARTO,175,LA GILDA,ESC PROV JOSE DE SAN MARTIN - PUBLICA S/N,1,5739,5739,73
13,RIO CUARTO,176,LA INVERNADA,ESC R ESCALADA DE SAN MARTIN - LA INVERNDA,1,5740,5740,71
13,RIO CUARTO,177,LAS ACEQUIAS,ESC LEONILA DE LAS M LEMOS - MAIPU 535 NORTE,8,5741,5748,2569
13,RIO CUARTO,178,LAS CAÑITAS,ESC.PROV.J.DE SAN MARTIN - LAS CAÑITAS,1,5749,5749,49
13,RIO CUARTO,178A,LAS ALBAHACAS,ESC.C.G. DE REZZANO - CALLE 11,2,5750,5751,440
13,RIO CUARTO,178B,VILLA EL CHACAY,ESC.ALBERGUE J.HERNANDEZ - PUBLICA,1,5752,5752,126
13,RIO CUARTO,179,LAS HIGUERAS,ESC JORGE ALEHANDRO NEWBERY - ESPAÑA 36,14,5753,5766,4830
13,RIO CUARTO,179,LAS HIGUERAS,JARD INF JORGE A NEWBERY - ESPAÑA 86 B° SAN MARTIN,4,5767,5770,1379
13,RIO CUARTO,180,LAS PEÑAS,ESC.PROV.J.M.PAZ - AVDA. 22 DE OCTUBRE,1,5771,5771,215
13,RIO CUARTO,181,LOS CUATRO VIENTOS,ESC ANTONIO SOBRAL - PUBLICA S/N,1,5772,5772,168
13,RIO CUARTO,182,LAS VERTIENTES,ESC CAP DE FRAGATA MOYANO - JULIANA GARCIA PUBLILL 560,3,5773,5775,908
13,RIO CUARTO,183,VICUÑA MACKENNA,INST JUAN PASCUAL PRINGLES - AV CARLOS S YDE 684,10,5776,5785,3390
13,RIO CUARTO,183,VICUÑA MACKENNA,ESC GUIDO SPANO - SARMIENTO 672 CENTRO,8,5786,5793,2709
13,RIO CUARTO,183,VICUÑA MACKENNA,ESC GRAL NAPOLEON URIBURU - LIB GENERAL SAN MARTIN 318 CENTRO,9,5794,5802,3042
13,RIO CUARTO,184,MOLDES,ESC FRAY MARCOS DONATTI - MOLDES,9,5803,5811,3050
13,RIO CUARTO,184,MOLDES,IPEM N°94 DOLORES L DE LAVALLE - MOLDES,8,5812,5819,2704
13,RIO CUARTO,184,MOLDES,ESC NICOLAS AVELLANEDA - MOLDES,7,5820,5826,2366
13,RIO CUARTO,184A,MONTE DE LOS GAUCHOS,ESC.PROV.M.BELGRANO - SARMIENTO,2,5827,5828,686
13,RIO CUARTO,186,PUEBLO ALBERDI,ESC NICOLAS AVELLANEDA - VICENTE LOPEZ 538,12,5829,5841,4104
13,RIO CUARTO,186,PUEBLO ALBERDI,IPEMN° 26 JUAN FILLOY - BELISARIO ROLDAN 535,10,5842,5851,3420
13,RIO CUARTO,186,PUEBLO ALBERDI,COLEGIO MARIA BENITA ARIAS - MONTEVIDEO 751,10,5852,5861,3420
13,RIO CUARTO,186,PUEBLO ALBERDI,ESC GRAL JUSTO S ANAYA - AZOPARDO 1270 FENIX,14,5862,5875,4788
13,RIO CUARTO,186,PUEBLO ALBERDI,INST LANTERIANO LA MERCED - BELISARIO ROLDAN 275,18,5876,5893,6156
13,RIO CUARTO,186,PUEBLO ALBERDI,ESC ARZOBISPO ANTONIO ESPINOSA - OLEGARIO ANDRADE 1020,11,5894,5904,3761
13,RIO CUARTO,187,PUEYRREDON,ESC CAP DE NAV S ALBARRACIN - PUEYRREDON,1,5905,5905,103
13,RIO CUARTO,188,RIO CUARTO,ESC.NORM.NAC.MIXTA - CONSTITUCION 1040,24,5906,5929,8280
13,RIO CUARTO,188,RIO CUARTO,INST SAN BUENAVENTURA - SAN MARTIN 250,12,5930,5941,4140
13,RIO CUARTO,188,RIO CUARTO,ESC FLORENTINO AMEGHINO - 9 DE JULIO 314,10,5942,5951,3450
13,RIO CUARTO,188,RIO CUARTO,DICHIARA-EX ESC.GRAL S.MARTIN - BOLIVAR Y ALBERDI,9,5952,5960,3105
13,RIO CUARTO,188,RIO CUARTO,ESCUELA GENERAL PAZ - MITRE 850,13,5961,5973,4485
13,RIO CUARTO,188,RIO CUARTO,COL NTRA SRA DEL CARMEN - BAIGORRIA 373,17,5974,5990,5865
13,RIO CUARTO,188,RIO CUARTO,ESC ALTE BROWN - RIO QUINTO 660,8,5991,5998,2760
13,RIO CUARTO,188,RIO CUARTO,ESCUELA GRAL ROCA - PASO 790 B° SANTA ROSA,12,5999,6010,4140
13,RIO CUARTO,188,RIO CUARTO,ESC BARTOLOME MITRE - LAVALLE 1452,12,6011,6022,4134
13,RIO CUARTO,188,RIO CUARTO,ESC 21 DE JULIO - BAIGORRIA 552,10,6023,6032,3440
13,RIO CUARTO,188,RIO CUARTO,ESC MANUEL BELGRANO - SOBREMONTE 1333,14,6033,6046,4816
13,RIO CUARTO,188,RIO CUARTO,E.N.E.T. N° 1 - BAIGORRIA 527,12,6047,6058,4128
13,RIO CUARTO,188,RIO CUARTO,ESC.NORMAL COMERCIAL - BAIGORRIA 463,27,6059,6085,9288
13,RIO CUARTO,188,RIO CUARTO,ESC VELEZ SARSFIELD - MENDOZA 1502,10,6086,6095,3440
13,RIO CUARTO,188,RIO CUARTO,ESCUELA PIAS - BV GRAL ROCA 701,8,6096,6103,2752
13,RIO CUARTO,188,RIO CUARTO,COLEGIO GALILEO GALILEI - ALVEAR 1040,12,6104,6115,4128
13,RIO CUARTO,188,RIO CUARTO,COLEGIO HISPANO ARGENTINO - FOTHERINGHAM 68,14,6116,6129,4816
13,RIO CUARTO,189,SAMPACHO,INSTITUTO LA CONSOLATA - HIPOLITO IRIGOYEN 482,7,6130,6136,2373
13,RIO CUARTO,189,SAMPACHO,ESC SAN MARTIN - SAMPACHO,7,6137,6143,2366
13,RIO CUARTO,189,SAMPACHO,INSTPABLO ANTONIO PIZZURNO - SAMPACHO,8,6144,6151,2704
13,RIO CUARTO,190,SAN AMBROSIO,ESC.SAN JUAN BOSCO - PUBLICA,1,6152,6152,128
13,RIO CUARTO,191,SAN BASILIO,INST JUAN BAUTISTA ALBERDI - BV LORENZO BERARDO 325 NORTE,4,6153,6156,1308
13,RIO CUARTO,191,SAN BASILIO,ESC JOSE DE SAN MARTIN - BELGRANO 121 B°CENTRO,6,6157,6162,1958
13,RIO CUARTO,191A,MALENA,ESC.PROV.R.E.DE SAN MARTIN - REMEDIOS ESCALADA DE SAN MARTIN,1,6163,6163,308
13,RIO CUARTO,192,SUCO,ESC R ESCALADA DE SAN MARTIN - SUCO,2,6164,6165,477
13,RIO CUARTO,193,TOSQUITA,ESC.PROV.J.M.ESTRADA - AVELLANEDA 181,2,6166,6167,526
13,RIO CUARTO,194,WASHINGTON,ESCUELA N°359 - WASHINGTON,3,6168,6169,556
14,RIO PRIMERO,195,ATAHONA,ESC.PROV.J.DE SAN MARTIN - PUBLICA S/N,1,6170,6170,166
14,RIO PRIMERO,196,CAÑADA DE MACHADO,ESC.PROV.M.MORENO - CALLE 12,1,6171,6171,229
14,RIO PRIMERO,197,LA POSTA,ESC PROV JOAQUIN V GONZALEZ - JOAQUIN V GONZALEZ S/N,1,6172,6172,337
14,RIO PRIMERO,198,CAPILLA DE REMEDIOS,ESC PROV MARTIN GUEMES - MARTIN GUEMES S/N,4,6173,6176,1065
14,RIO PRIMERO,199,CHALACEA,ESCUELA N°315 - CHALACEA,1,6177,6177,230
14,RIO PRIMERO,200,DIEGO DE ROJAS,ESC M.C.CALDECOT DE ARGUELLO - FIGUEROA ALCORTA S/N,2,6178,6179,503
14,RIO PRIMERO,201,COLONIA LAS CUATRO ESQUINAS,ESC JOSE MARIA PAZ - LAS CUATRO ESQUINAS,1,6180,6180,114
14,RIO PRIMERO,201A,LAS GRAMILLAS,ESC MAEST F BELLORA DE DAVILA - LAS GRAMILLAS,1,6181,6181,137
14,RIO PRIMERO,202,ESQUINA,ESC PROV JOSE MANUEL ESTRADA - MALVINAS ARGENTINAS S/N,1,6182,6182,341
14,RIO PRIMERO,203,PEDRO E.VIVAS,ESC.R.E.DE SAN MARTIN - KM. 658,2,6183,6184,352
14,RIO PRIMERO,204,LA PARA,INST MONSEÑOR ESQUIU - MARIANO MORENO 749 CENTRO,6,6185,6190,2004
14,RIO PRIMERO,204,LA PARA,ESC MARIANO FRAGUEIRO - MARIANO FRAGUEIRO 385,5,6191,6195,1665
14,RIO PRIMERO,205,LA PUERTA,ESC PROV FRAY MAMERTO ESQUIU - SAN LORENZO 698,6,6196,6201,2012
14,RIO PRIMERO,206,LAS HERAS,ESCUELA N°411 - LA CAÑADA,1,6202,6202,61
14,RIO PRIMERO,207,LAS SALADAS,ESC DALMIRA MURO(EX DEL CHACO) - LAS SALADAS,1,6203,6203,257
14,RIO PRIMERO,208,COMECHINGONES,ESCUELA N°111 - COMECHINGONES,1,6204,6204,311
14,RIO PRIMERO,209,MAQUINISTA GALLINI,ESC.PROV.J.M.PAZ - PUBLICA,1,6205,6205,182
14,RIO PRIMERO,210,BLAS DE ROSALES,ESC DOMINGO F SARMIENTO - PUBLICA S/N(HOY:BLAS DE ROSALES),1,6206,6206,106
14,RIO PRIMERO,211,MONTE CRISTO,MARGARITA V LUDUEÑA DE LAZO - SARMIENTO   LAS MALVINAS 571,8,6207,6214,2701
14,RIO PRIMERO,211,MONTE CRISTO,INST PQUIAL MONTE CRISTO - ROQUE SAENZ PEÑA 380,12,6215,6226,4044
14,RIO PRIMERO,211,MONTE CRISTO,ESCUELA MAESTRO DOMINGO NOGAL - AV SAN MARTIN,8,6227,6234,2696
14,RIO PRIMERO,212,MONTE DEL ROSARIO,ESC.PROV.J.M.PAZ - PUBLICA,1,6235,6235,146
14,RIO PRIMERO,212B,EL CRISPIN,ESC PROV DOMINGO F SARMIENTO - PUBLICA S/N,1,6236,6236,253
14,RIO PRIMERO,213,OBISPO TREJO,ESCUELA R.GUTIERREZ - GENERAL PAZ 788,7,6237,6243,2407
14,RIO PRIMERO,214,PIQUILLIN,ESC.PROV.D.F.SARMIENTO - AVDA.SARMIENTO E 74,5,6244,6248,1676
14,RIO PRIMERO,215,PLAZA DE MERCEDES,ESC.PROV.M.BELGRANO - CHACON DE CUESTAS,1,6249,6249,140
14,RIO PRIMERO,215A,LA QUINTA,ESC PROV JUAN JOSE PASO - PUBLICA S/N,1,6250,6250,255
14,RIO PRIMERO,216,PUNTA DEL AGUA,ESC.PROV.GRAL SAN MARTIN - PUBLICA,1,6251,6251,38
14,RIO PRIMERO,217,QUEBRACHO,ESC.PROV.1ER.GOBIERNO PATRIO - QUEBRACHO,1,6252,6252,93
14,RIO PRIMERO,218,RIO PRIMERO,EX-ESCUELA N°279 - PABLO ROBERT 182,8,6253,6260,2660
14,RIO PRIMERO,218,RIO PRIMERO,ESC GRAL JOSE DE SAN MARTIN - CORRIENTES   LUCHI 251,8,6261,6268,2656
14,RIO PRIMERO,218,RIO PRIMERO,IPEM N° 164 ATALIVA HERRERA - AV CONTARDO FERRINI 365,4,6269,6272,1328
14,RIO PRIMERO,219,SAGRADA FAMILIA,ESC.JORGE NEWBERY - PUBLICA,1,6273,6273,181
14,RIO PRIMERO,220,VILLA SANTA ROSA,INST DEL SANTISIMO ROSARIO - SAN MARTIN 756,7,6274,6280,2317
14,RIO PRIMERO,220,VILLA SANTA ROSA,ESC PBRO JOSE G BROCHERO - SANTA ROSA,7,6281,6287,2310
14,RIO PRIMERO,220,VILLA SANTA ROSA,INSTITUTO EL SALVADOR - SANTA ROSA,8,6288,6295,2640
14,RIO PRIMERO,221,EL ALCALDE,ESC PROV R SAENZ PEÑA - EL ALCALDE,1,6296,6296,116
14,RIO PRIMERO,222,VILLA FONTANA,IPEM N°228-SAN ISIDRO LABRADOR - AV PEDRO J FONTANA 448,3,6297,6299,911
15,RIO SECO,223,CANDELARIA NORTE,ESC.PROV.C.SAAVEDRA - PUBLICA,3,6300,6302,764
15,RIO SECO,224,ENCRUCIJADA,ESC PROV PRIMERA JUNTA - ENCRUCIJADA,1,6303,6303,42
15,RIO SECO,225,GUTEMBERG,ESC GRAL SAN MARTIN - PUBLICA S/N,3,6304,6306,860
15,RIO SECO,225A,LA CAÑADA,ESC PROV GENERAL PAZ - PUBLICA S/N,1,6307,6307,89
15,RIO SECO,226,LOS HOYOS,ESC PRO MARTIN GUEMES - PUBLICA S/N,2,6308,6309,453
15,RIO SECO,226A,PUESTO DE CASTRO,ESC.PROV.D.F.SARMIENTO - PUESTO DE CASTRO,2,6310,6311,439
15,RIO SECO,227,RAYO CORTADO,ESC.PROV.CNEL.F.DE BEDOYA - RAYO CORTADO,3,6312,6314,700
15,RIO SECO,227A,RINCONADA,ESC PROV GUILLERMO BROWN - PUBLICA S/N,2,6315,6316,466
15,RIO SECO,227B,CERRO COLORADO,ESC PROV LUCIANO ARGUELLO - CERRO COLORADO,1,6317,6317,339
15,RIO SECO,227C,CHAÑAR VIEJO,ESC PROV G MARTINEZ PIZARRO - PUBLICA S/N,1,6318,6318,207
15,RIO SECO,227D,SANTA ELENA,ESC PROV ING FEDERICO NEHHER - PUBLICA S/N,2,6319,6320,346
15,RIO SECO,228,SEBASTIAN ELCANO,ESC.PROV. CNEL. A.H.CARPANI - MAESTRO PIÑA 279,8,6321,6328,2514
15,RIO SECO,229,VILLA DE MARIA,ESC JOSE DE SAN MARTIN - RIVADAVIA 768 CENTRO,7,6329,6335,2415
15,RIO SECO,229,VILLA DE MARIA,IPEM 224-LEOPOLDO LUGONES - RECONQUISTA,7,6336,6342,2408
15,RIO SECO,229A,EUFRASIO LOZA,ESC PROV LEOPOLDO LUGONES - SANTIAGO DEL ESTERO S/N,1,6343,6343,205
16,RIO SEGUNDO,230,CALCHIN,COLEGIO ENS.SECUNDARIA - CALCHIN,7,6344,6350,2150
16,RIO SEGUNDO,230A,CALCHIN OESTE,ESC.PROV.M.BELGRANO - CALCHIN OESTE,2,6351,6352,668
16,RIO SEGUNDO,231,CAPILLA DEL CARMEN,ESCUELA NARCISO LAPRIDA - GRAL JOSE DE SAN MARTIN S/N,2,6353,6354,364
16,RIO SEGUNDO,232,CARRILOBO,ESC PROV PTE JULIO ROCA - MARIANO MORENO 815,5,6355,6359,1705
16,RIO SEGUNDO,233,COLAZO,ESC PROV SEMANA DE MAYO - ADALGISA 427,4,6360,6363,1373
16,RIO SEGUNDO,234,COSTA SACATE,ESC LIB GRAL SAN MARTIN - PUBLICA S/N,4,6364,6367,1377
16,RIO SEGUNDO,235,LAGUNA LARGA,ESC BERNARDINO RIVADAVIA - RIVADAVIA 66 MALVINAS ARGENTINAS,8,6368,6375,2732
16,RIO SEGUNDO,235,LAGUNA LARGA,ESC NARCISO LAPRIDA - NARCISO LAPRIDA S/N,7,6376,6382,2387
16,RIO SEGUNDO,235,LAGUNA LARGA,INST GRAL JOSE MARIA PAZ - BV RIO CUARTO 599 CENTRO,5,6383,6387,1705
16,RIO SEGUNDO,236,LAS JUNTURAS,I.P.E.A.(IPEM231 TORAZO) - LAS JUNTURAS,5,6388,6392,1545
16,RIO SEGUNDO,236A,COLONIA VIDELA,ESC.PROV.D.F.SARMIENTO - PUBLICA,1,6393,6393,45
16,RIO SEGUNDO,237,LUQUE,IPEM N° 300 - LUQUE,7,6394,6400,2289
16,RIO SEGUNDO,237,LUQUE,ESC GRAL JOSE DE SAN MARTIN - LUQUE,10,6401,6410,3266
16,RIO SEGUNDO,237A,MANFREDI,ESCUELA N°57 - MANFREDI,3,6411,6413,918
16,RIO SEGUNDO,237B,PUEBLO LUDUEÑA,ESC PROV JERONIMO L DE CABRERA - PUBLICA S/N-IMPIRA,1,6414,6414,189
16,RIO SEGUNDO,238,MATORRALES,ESC.PROV.D.F.SARMIENTO - CORRIENTES 237,3,6415,6417,956
16,RIO SEGUNDO,239,ONCATIVO,ESC JOSE MARIA PAZ - ONCATIVO,12,6418,6429,4110
16,RIO SEGUNDO,239,ONCATIVO,ESC DE COM L LUGONES(IPEM 158) - ONCATIVO,7,6430,6436,2394
16,RIO SEGUNDO,239,ONCATIVO,ESC EMILIO F OLMOS - ONCATIVO,7,6437,6443,2394
16,RIO SEGUNDO,239,ONCATIVO,IPEM N°54 J E MULLER - 25 DE MAYO S/N,9,6444,6452,3078
16,RIO SEGUNDO,240,PILAR,ESC ZENON LOPEZ - PILAR,14,6453,6466,4713
16,RIO SEGUNDO,240,PILAR,ESC JUAN BAUTISTA BUSTOS - PILAR,6,6467,6472,2016
16,RIO SEGUNDO,240,PILAR,ESC MARIA J GONZALEZ CASEROS - PILAR,11,6473,6483,3696
16,RIO SEGUNDO,240,PILAR,INST CARLOS PELLEGRINI - PILAR,6,6484,6489,2016
16,RIO SEGUNDO,241,POZO DEL MOLLE,ESC GENERAL SAN MARTIN - POZO DEL MOLLE,11,6490,6500,3610
16,RIO SEGUNDO,241,POZO DEL MOLLE,ESC FRANCISCO MALBRAN - POZO DEL MOLLE,6,6501,6506,1968
16,RIO SEGUNDO,242,RINCON,ESC PROV NICOLAS AVELLANEDA - RINCON,2,6507,6508,446
16,RIO SEGUNDO,242A,CAÑADA DE MACHADO SUD,ESC MARIANO MORENO - CAÑADA DE MACHADO SUD,1,6509,6509,17
16,RIO SEGUNDO,243,RIO SEGUNDO,C.E.N.M.A. N° 161 - SAN MARTIN ESQ ALEM,6,6510,6515,2046
16,RIO SEGUNDO,243,RIO SEGUNDO,IPEM N°108-C G DE REZZANO - RIO SEGUNDO,11,6516,6526,3751
16,RIO SEGUNDO,243,RIO SEGUNDO,ESC PRIMER GOBIERNO PATRIO - RIVADAVIA 915,13,6527,6539,4423
16,RIO SEGUNDO,243,RIO SEGUNDO,ESC VICTOR MERCANTE - MARCONI 591 BELGRANO,12,6540,6551,4080
16,RIO SEGUNDO,243,RIO SEGUNDO,ESC CONGRESO DE TUCUMAN - RIO SEGUNDO,10,6552,6561,3400
16,RIO SEGUNDO,244,SANTIAGO TEMPLE,ESC CORONEL PRINGLES - SANTIAGO TEMPLE,8,6562,6569,2425
16,RIO SEGUNDO,244A,LOS CHAÑARITOS,ESC PROV ESTANISLAO DEL CAMPO - PUBLICA S/N,1,6570,6570,278
16,RIO SEGUNDO,245,VILLA DEL ROSARIO,ESCUELA RECONQUISTA - VILLA DEL ROSARIO,10,6571,6580,3429
16,RIO SEGUNDO,245,VILLA DEL ROSARIO,ESC MARQUES DE SOBREMONTE - VILLA DEL ROSARIO,13,6581,6593,4446
16,RIO SEGUNDO,245,VILLA DEL ROSARIO,COLEGIO SAN JOSE - VILLA DEL ROSARIO,15,6594,6608,5130
17,ROQUE SAENZ PEÑA,248,LABOULAYE,I.P.E.M. 278-M.ARGENTINAS - AV INDEPENDENCIA(B°CENTRO) 475,9,6609,6617,3069
17,ROQUE SAENZ PEÑA,248,LABOULAYE,ESC GRAL CONRADO VILLEGAS - INTENDENTE FENOGLIO(B° SANTA RITA) 344,10,6618,6627,3410
17,ROQUE SAENZ PEÑA,248,LABOULAYE,ESC LEONOR DE TEJEDA - AV PELLEGRINI(B°LA CHACARITA) 247,6,6628,6633,2046
17,ROQUE SAENZ PEÑA,248,LABOULAYE,COLEGIO SAN JOSE - RIVADAVIA(B°CENTRO) 245,8,6634,6641,2728
17,ROQUE SAENZ PEÑA,248,LABOULAYE,IPEM 257 DR RENE FAVALORO - AV INDEPENDENCIA(B°TERMINAL) 512,10,6642,6651,3405
17,ROQUE SAENZ PEÑA,248,LABOULAYE,ESC JUAN PASCUAL PRINGLES - AV INDEPENDENCIA(B°SUR) 284,10,6652,6661,3400
17,ROQUE SAENZ PEÑA,249,LA CESIRA,ESC VICTORIANO RODRIGUEZ - ALVEAR 220,5,6662,6666,1399
17,ROQUE SAENZ PEÑA,251,LEGUIZAMON,ESC N°78-PINTOR JUAN M BLANES - LEGUIZAMON,1,6667,6667,120
17,ROQUE SAENZ PEÑA,252,LEVALLE,ESC GRAL NICOLAS LEVALLE - BERNARDINO ANCE(B°NORTE) 601,7,6668,6674,2366
17,ROQUE SAENZ PEÑA,252,LEVALLE,ESC DR VIRGILIO BARBALATO - CARLOS PELLEGRINI(B°SUR) 331,8,6675,6682,2700
17,ROQUE SAENZ PEÑA,253,MELO,ESC.PROV.L.PASTEUR - PUBLICA,4,6683,6686,1147
17,ROQUE SAENZ PEÑA,254,RIO BAMBA,ESC RAUL SOULE(EX NAC N°241) - RIO BAMBA,1,6687,6687,99
17,ROQUE SAENZ PEÑA,255,ROSALES,ESC.PROV.P.B.PALACIOS - CORRIENTES,2,6688,6689,540
17,ROQUE SAENZ PEÑA,256,SAN JOAQUIN,ESC.PROV.GRAL SAN MARTIN - SAN JOAQUIN,1,6690,6690,146
17,ROQUE SAENZ PEÑA,257,SERRANO,INS SAN ALBERTO Y SAN ENRIQUE - SERRANO,9,6691,6699,3034
17,ROQUE SAENZ PEÑA,258,VILLA ROSSI,ESCUELA N°105(JOSE RUBIROLA) - VILLA ROSSI,2,6700,6701,568
18,SAN ALBERTO,259,ALTAUTINA,ESC.PROV.M.DE AZCUENAGA - PUBLICA,1,6702,6702,21
18,SAN ALBERTO,260,AMBUL,ESC.PROV.FRAY J.M.NOGAL - DOMINGO F SARMIENTO,3,6703,6705,944
18,SAN ALBERTO,260A,EL VOLCAN,ESC PROV JUAN P PRINGLES - PUBLICA S/N,1,6706,6706,35
18,SAN ALBERTO,261,BROCHERO,IPEM N° 344 - BROCHERO,7,6707,6713,2330
18,SAN ALBERTO,261,BROCHERO,ESC JOSE GABRIEL BROCHERO - MARIANO MORENO(B°CENTRO) 291,6,6714,6719,1992
18,SAN ALBERTO,261,BROCHERO,INST TRANSITO DE MARIA - IRINEO ALTAMIRANO(B°CENTRO) 60,4,6720,6723,1328
18,SAN ALBERTO,261A,SAN LORENZO,ESC PROV JUAN MARTIN RECALDE - PUBLICA S/N,3,6724,6726,961
18,SAN ALBERTO,261B,VILLA BENEGAS,ESC.PROV.GUIDO SPANO - PUBLICA,1,6727,6727,48
18,SAN ALBERTO,262,MINA CLAVERO,ESC GRAL JOSE DE SAN MARTIN - MINA CLAVERO,11,6728,6738,3784
18,SAN ALBERTO,262,MINA CLAVERO,ESC MAESTRO D F SARMIENTO - AV HERNAN CORTEZ(B°MAYTHE) 1.060,6,6739,6744,2064
18,SAN ALBERTO,262,MINA CLAVERO,IPEM N° 285-J G BROCHERO - LOS FUNDADORES S/N (B°SANTA ANA),7,6745,6751,2404
18,SAN ALBERTO,263,NONO,ESC.PROV.D.F.SARMIENTO - SARMIENTO 223,7,6752,6758,2381
18,SAN ALBERTO,263A,PAMPA DE ACHALA,ESCUELA 20 DE JUNIO - PUBLICA S/N,1,6759,6759,122
18,SAN ALBERTO,263B,LOS CERROS,ESC PROV CEFERINO NAMUNCURA - PUBLICA S/N,1,6760,6760,20
18,SAN ALBERTO,263C,ARROYO DE LOS PATOS,ESC J V LOPEZ(EX-NAC N°493) - RUTA N°14 Y ESMERALDA,2,6761,6762,610
18,SAN ALBERTO,263D,LAS CALLES,ESC.PROV.M.A DE CARRANZA PREGO - LAS CALLES,2,6763,6764,506
18,SAN ALBERTO,263E,LAS RABONAS,ESC.PROV.M.BELGRANO - RUTA NAC 14,3,6765,6767,717
18,SAN ALBERTO,264,PANAHOLMA,ESC.P.PIZZURNO - PUBLICA,2,6768,6769,396
18,SAN ALBERTO,264A,LOS ESPINILLOS,ESC TOMAS DE IRIARTE - LOS ESPINILLOS,1,6770,6770,223
18,SAN ALBERTO,265,SAN PEDRO,ESC CNEL OLMEDO - CECILIA FUNES(B°CENTRO) 140,13,6771,6783,4175
18,SAN ALBERTO,265A,VILLA SARMIENTO,ESC CNEL AGUSTIN A OLMEDO - LIBERTAD (B°CENTRO) 270,13,6784,6796,4457
18,SAN ALBERTO,265B,LA CORTADERA,ESC PROV MARIO REMORINO - PUBLICA S/N,1,6797,6797,82
18,SAN ALBERTO,265C,SAUCE ARRIBA,ESC.PROV.FRAY L.BELTRAN - PUBLICA,3,6798,6800,797
18,SAN ALBERTO,266,SAN VICENTE,ESC MAESTRO H GALABURRI - PUBLICA S/N,5,6801,6805,1404
18,SAN ALBERTO,266A,SAN RAFAEL,ESC MARCELO T DE ALVEAR - SAN RAFAEL,1,6806,6806,158
19,SAN JAVIER,267,CONLARA,ESC PROV NARCISO LAPRIDA - PUBLICA S/N,2,6807,6808,401
19,SAN JAVIER,268,DOLORES,ESC MARIANO MORENO - PRESIDENTE PERON (B°JARDIN) 565,10,6809,6818,3450
19,SAN JAVIER,268,DOLORES,INST PBRO J V BRIZUELA - SARMIENTO (B°CENTRO) 270,9,6819,6827,3105
19,SAN JAVIER,268,DOLORES,ESC.NORMAL SARSFIELD - AV.S.MARTIN 271,15,6828,6842,5175
19,SAN JAVIER,268,DOLORES,ESC GENERAL SAN MARTIN - EDISON 130,14,6843,6856,4830
19,SAN JAVIER,268,DOLORES,ESC MANUEL BELGRANO - AV BELGRANO (B°FATIMA) 1.399,7,6857,6863,2415
19,SAN JAVIER,268,DOLORES,COLEGIO SAGRADO CORAZON - HORMAECHE (B°JARDIN) 375,9,6864,6872,3097
19,SAN JAVIER,268,DOLORES,ESC C CENTENARIO-IPEM N° 146 - PEDRO C MOLINA 145,8,6873,6880,2752
19,SAN JAVIER,268,DOLORES,ESC DOLORES AGUIRRE DE FUNES - PEDRO C MOLINA S/N(B°TRADICION,7,6881,6887,2408
19,SAN JAVIER,269,LA PAZ,INST JUAN BAUTISTA ALBERDI - LA PAZ,4,6888,6891,1268
19,SAN JAVIER,269,LA PAZ,ESC PROV JOSE M PAZ - VELEZ SARSFIELD Y BRAULIO FUNES,5,6892,6896,1584
19,SAN JAVIER,269A,QUEBRACHO LADEADO,ESC.PROV.J.M.ESTRADA - PUBLICA,1,6897,6897,254
19,SAN JAVIER,269B,EL MANANTIAL,ESC PROV JUAN JOSE PASO - RUTA NACIONAL 148 S/N,1,6898,6898,29
19,SAN JAVIER,270,LAS ROSAS,ESC MAGDALENA T DE CHARLES - PUBLICA S/N,9,6899,6907,3024
19,SAN JAVIER,270,LAS ROSAS,INST. VILLA DE LAS ROSAS - AV BELGRANO 350,4,6908,6911,1340
19,SAN JAVIER,271,LAS TAPIAS,ESC LEOPOLDO LUG0NES - LAS TAPIAS,5,6912,6916,1523
19,SAN JAVIER,272,LOS HORNILLOS,ESC JOSE DE SAN MARTIN - GRAL SAN MARTIN S/N,4,6917,6920,1169
19,SAN JAVIER,273,LUYABA,ESC.PROV.EMILIO F.OLMOS - PUBLICA,4,6921,6924,1208
19,SAN JAVIER,274,SAN JAVIER,ESC GENERAL SAN MARTIN - SAN JAVIER,3,6925,6927,724
19,SAN JAVIER,274A,LA POBLACION,ESCUELA PROVINCIAL - PUBLICA S/N,2,6928,6929,459
19,SAN JAVIER,275,SAN JOSE,ESC EMILIO FELIPE OLMOS - AV SAN MARTIN S/N,7,6930,6936,2119
19,SAN JAVIER,275A,LOS CERRILLOS,ESC GENERAL BARTOLOME MITRE - LOS CERRILLOS,6,6937,6942,2021
19,SAN JAVIER,276,YACANTO,ESC GENERAL SAN MARTIN - PUBLICA,4,6943,6946,1177
20,SAN JUSTO,277,ALICIA,ESC JOSE MANUEL ESTRADA - ALICIA,4,6947,6950,1340
20,SAN JUSTO,277,ALICIA,ESC FRAY CAYETANO RODRIGUEZ - ALICIA,5,6951,6955,1675
20,SAN JUSTO,278,ALTOS DE CHIPION,ESC.PROV.RECONQUISTA - SARMIENTO 543,6,6956,6961,1853
20,SAN JUSTO,279,ARROYITO,ESC MANUEL BELGRANO - RIVADAVIA (B°CENTRO) 473,11,6962,6972,3740
20,SAN JUSTO,279,ARROYITO,ESC JOSE MARIA PAZ - RIVADAVIA (B°CENTRO) 473,9,6973,6981,3051
20,SAN JUSTO,279,ARROYITO,INST DR D VELEZ SARSFIELD - ARROYITO,15,6982,6996,5085
20,SAN JUSTO,279,ARROYITO,ESCUELA N°198(ESC GIMENEZ LAGO - ARROYITO,14,6997,7010,4746
20,SAN JUSTO,279,ARROYITO,CERVELLON/NTRA S DE LA MERCED - 9 DE JULIO (B°CENTRO) 465,9,7011,7019,3051
20,SAN JUSTO,279A,EL FUERTECITO,ESC PROV ALTE GUILLERMO BROWN - ALICIA ROSSI 441,2,7020,7021,373
20,SAN JUSTO,280,BALNEARIA,ESC VICENTE LOPEZ Y PLANES - 25 DE MAYO (B°IPV NORTE) 271,6,7022,7027,1986
20,SAN JUSTO,280,BALNEARIA,ESC PABLO JULIO RODRIGUEZ - GENERAL LAVALLE (B°IPV NORTE) 150,7,7028,7034,2312
20,SAN JUSTO,280,BALNEARIA,INST JUAN BAUTISTA ALBERDI - BALNEARIA,4,7035,7038,1320
20,SAN JUSTO,281,BEIRO,ESCUELA N°349(ESC JUAN BEIRO) - BEIRO,1,7039,7039,155
20,SAN JUSTO,282,BRINKMANN,COLEGIO MANUEL BELGRANO - AV SEEBER (B°MANUEL BELGRANO) 317,7,7040,7046,2380
20,SAN JUSTO,282,BRINKMANN,ESC 25 DE MAYO - 25 DE MAYO 975(B°25 DE MAYO),10,7047,7056,3390
20,SAN JUSTO,282,BRINKMANN,IPETIN 262 BELISARIO ROLDAN - DR PITT FUNES B°BERTOSSI 547,8,7057,7064,2712
20,SAN JUSTO,283,CONCEPCION,ESC.PROV.M.MORENO - TUCUMAN 483,6,7065,7070,1767
20,SAN JUSTO,283A,COLONIA PICHANAS,ESC CONGRESO DE TUCUMAN - COLONIA PICHANAS,1,7071,7071,170
20,SAN JUSTO,285,DEVOTO,ESC CARLOS J FLORIT - DEVOTO,10,7072,7081,3445
20,SAN JUSTO,285,DEVOTO,ESC DOMINGO F SARMIENTO - DEVOTO,6,7082,7087,2064
20,SAN JUSTO,286,DIEZ DE JULIO,ESC PROV DOMINGO F SARMIENTO - PUBLICA S/N,1,7088,7088,151
20,SAN JUSTO,287,DOS HERMANOS,ESC PROV L DE LA TORRE - PUBLICA S/N,1,7089,7089,125
20,SAN JUSTO,288,EL ARAÑADO,ESC PROV CHACABUCO - 25 DE MAYO 381,6,7090,7095,1965
20,SAN JUSTO,288A,VILLA SAN ESTEBAN,ESCUELA PROV. ANTONIO SOBRAL - PUBLICA,1,7096,7096,189
20,SAN JUSTO,289,EL FORTIN,ESC PROV DOMINGO F SARMIENTO - MATEO OLIVERO 576,4,7097,7100,1212
20,SAN JUSTO,290,EL TIO,ESC PROV JOSE MARIA PAZ - 15 DE OCTUBRE 588,3,7101,7103,926
20,SAN JUSTO,290,EL TIO,IPEM N°166 CAP G DEL VALLE - EL TIO,3,7104,7106,924
20,SAN JUSTO,291,FREYRE,COL STA TERESITA DEL N JESUS - BV 12 DE OCTUBRE 681,8,7107,7114,2736
20,SAN JUSTO,291,FREYRE,ESC FLORENTINO AMEGHINO - FREYRE,10,7115,7124,3416
20,SAN JUSTO,291A,COLONIA ANITA,ESC PROV RAMON J CARCANO - PUBLICA S/N,1,7125,7125,79
20,SAN JUSTO,292,ITURRASPE,ESC THOMAS ALVA EDISON - ITURRASPE,1,7126,7126,112
20,SAN JUSTO,293,LA FRANCIA,INST COM SEC LA FRANCIA - LA FRANCIA,5,7127,7131,1605
20,SAN JUSTO,293,LA FRANCIA,ESC PROV DAMAS PATRICIAS - LA FRANCIA,6,7132,7137,1925
20,SAN JUSTO,294,LA PAQUITA,ESC PROV MARIANO MORENO - ALTE BROWN 231,3,7138,7140,987
20,SAN JUSTO,294A,COLONIA VALTELINA,ESC PROV NICOLAS AVELLANEDA - SARMIENTO S/N,1,7141,7141,182
20,SAN JUSTO,295,LA TORDILLA,ESC MARGARITA LA TORRE MERCADO - 8 DE SEPTIEMBRE 107,5,7142,7146,1566
20,SAN JUSTO,295A,TORO PUJIO,ESC.PROV.J.M.ESTRADA - PUBLICA,1,7147,7147,252
20,SAN JUSTO,296,LASPIUR,IPEM N°287-L LUGONES - LASPIUR,7,7148,7154,2376
20,SAN JUSTO,297,LAS VARAS,ESC PROV MARIANO MORENO - LAS VARAS,4,7155,7158,1177
20,SAN JUSTO,298,LAS VARILLAS,ESC NORM SUP D VELEZ SARSFIELD - ESCRIBANO LUIS MORELLI 188,18,7159,7176,6156
20,SAN JUSTO,298,LAS VARILLAS,ESCUELA GRAL PAZ - BUENOS AIRES 460,6,7177,7182,2052
20,SAN JUSTO,298,LAS VARILLAS,ESC BERNARDINO RIVADAVIA - INDEPENDENCIA 294,8,7183,7190,2728
20,SAN JUSTO,298,LAS VARILLAS,ESC BARTOLOME MITRE - SGTO CABRAL 521,11,7191,7201,3751
20,SAN JUSTO,299,LUXARDO,ESC CONSTANCIO LUXARDO - PUBLICA S/N,2,7202,7203,358
20,SAN JUSTO,300,MARINA,INST SEC MANUEL DORREGO - SARMIENTO 295,4,7204,7207,1208
20,SAN JUSTO,301,MARULL,ESC.REP DEL PARAGUAY - BELGRANO 234,6,7208,7213,1757
20,SAN JUSTO,302,MAUNIER,ESC PROV GRAL SAN MARTIN - PUBLICA S/N,1,7214,7214,113
20,SAN JUSTO,303,MIRAMAR,ESC.PROV.J.L.DE CABRERA - JERONIMO LUIS DE CABRERA,7,7215,7221,2081
20,SAN JUSTO,304,MORTEROS,COLEGIO NACIONAL MIXTO - MORTEROS,14,7222,7235,4821
20,SAN JUSTO,304,MORTEROS,ESC D VELEZ SARSFIELD - EMILIO F OLMOS 375,11,7236,7246,3784
20,SAN JUSTO,304,MORTEROS,ESCUELA CRISTO REY - BV 9 DE JULIO 1.008,16,7247,7262,5504
20,SAN JUSTO,304,MORTEROS,ESC BERNARDINO RIVADAVIA - SARMIENTO 208,5,7263,7267,1720
20,SAN JUSTO,305,PORTEÑA,INST BERNARDINO RIVADAVIA - PORTEÑA,8,7268,7275,2650
20,SAN JUSTO,305,PORTEÑA,ESC PROV 9 DE JULIO - PORTEÑA,7,7276,7282,2317
20,SAN JUSTO,306,PROSPERIDAD,ESC PROV SANTIAGO DERQUI - JUAREZ CELMAN 357,2,7283,7284,553
20,SAN JUSTO,307,QUEBRACHO HERRADO,ESC.PROV.AYACUCHO - SARMIENTO,2,7285,7286,653
20,SAN JUSTO,308,SACANTA,INST MANUEL BELGRANO - BELGRANO 960,4,7287,7290,1308
20,SAN JUSTO,308,SACANTA,ESCUELA ITUZAINGO - ITUZAINGO 251,5,7291,7295,1632
20,SAN JUSTO,309,SAN BARTOLOME,ESC PROV PRIMERA JUNTA - 9 DE JULIO 576,5,7296,7300,1549
20,SAN JUSTO,310,SAN FRANCISCO SECC. SUR,ESC N AVELLANEDA(IPEM N°50) - RIVADAVIA 679,13,7301,7313,4459
20,SAN JUSTO,310,SAN FRANCISCO SECC. SUR,ESC GENERAL MITRE - SANTA FE 538,10,7314,7323,3430
20,SAN JUSTO,310,SAN FRANCISCO SECC. SUR,COL SUP SAN MARTIN - PJE CHAMPAGNAT (SUR) 57,13,7324,7336,4459
20,SAN JUSTO,310,SAN FRANCISCO SECC. SUR,ESCUELA 2 DE ABRIL - FALUCHO Y PEATONAL LARREA N S/N,10,7337,7346,3430
20,SAN JUSTO,310,SAN FRANCISCO SECC. SUR,ESCUELA RIO NEGRO - CASEROS(B°LA CONSOLATA) 518,11,7347,7357,3773
20,SAN JUSTO,310,SAN FRANCISCO SECC. SUR,ESCUELA N AVELLANEDA - RIVADAVIA 648,16,7358,7373,5476
20,SAN JUSTO,310,SAN FRANCISCO SECC. SUR,ESCUELA RAFAEL NUÑEZ - PARAGUAY(B°CATEDRAL) 1.776,8,7374,7381,2736
20,SAN JUSTO,310A,SAN FRANCISCO SECC. NORTE,ESC JOSE BERRNARDO ITURRASPE - CABRERA(B°GENERAL ROCA) 1.736,16,7382,7397,5494
20,SAN JUSTO,310A,SAN FRANCISCO SECC. NORTE,ESC DOMINGO F SARMIENTO - ALMAFUERTE (B°ROCA) 104,10,7398,7407,3430
20,SAN JUSTO,310A,SAN FRANCISCO SECC. NORTE,COL SAN FCO DE ASIS - JUAN JOSE PASO (B°VELEZ SARSFIELD) 1.650,9,7408,7416,3087
20,SAN JUSTO,310A,SAN FRANCISCO SECC. NORTE,COLEGIO SAGRADO CORAZON - 25 DE MAYO(B°ITURRASPE) 1.414,6,7417,7422,2058
20,SAN JUSTO,310A,SAN FRANCISCO SECC. NORTE,ESCUELA PRIMERA JUNTA - ENTRE RIOS(B°GENERAL ROCA) 2.505,11,7423,7433,3773
20,SAN JUSTO,310A,SAN FRANCISCO SECC. NORTE,ESC PTE HIPOLITO IRIGOYEN - JUJUY(B°ITURRASPE) 205,13,7434,7446,4459
20,SAN JUSTO,310A,SAN FRANCISCO SECC. NORTE,ESC JOSE MARIA PAZ - REPUBLICA DEL LIBANO 1.009,12,7447,7458,4116
20,SAN JUSTO,310A,SAN FRANCISCO SECC. NORTE,INST PASCUAL BAILON SOSA - AV TRIGUEROS(B°INDEPENDENCIA) 151,2,7459,7460,686
20,SAN JUSTO,311,SAN PEDRO,ESC PROV 9 DE JULIO - COLONIA SAN PEDRO,1,7461,7461,264
20,SAN JUSTO,312,SAUZE,ESC.PROV.J.DE SAN MARTIN - SAUZE,1,7462,7462,22
20,SAN JUSTO,313,SEEBER,ESCUELA N°149(HOY:JOSE SEEBER) - SEEBER,2,7463,7464,659
20,SAN JUSTO,314,TRANSITO,ESC PROV R GUTIERREZ - TRANSITO,9,7465,7473,3044
20,SAN JUSTO,315,VIGNAUD,COL MARIA AUXILIADORA - ANA PASSADORE 611,2,7474,7475,645
21,SANTA MARIA,316,ALTA GRACIA,ESC COMANDANTE ESPORA - 3 DE FEBRERO(B° SUR) 362,12,7476,7487,4128
21,SANTA MARIA,316,ALTA GRACIA,ESC VICTOR MERCANTE - ANATOLE FRANCE(B°CARLOS PELLEGRINI) 360,8,7488,7495,2752
21,SANTA MARIA,316,ALTA GRACIA,INST EL OBRAJE (ARRIBA) - NIETO(B°POLUYAN) 17,6,7496,7501,2059
21,SANTA MARIA,316,ALTA GRACIA,INST DE LA MISERICORDIA - PADRE DOMINGO VIERA 151,10,7502,7511,3430
21,SANTA MARIA,316,ALTA GRACIA,INST SUP ANGLO AMERICANO - BV CARLOS PELLEGRINI 637,7,7512,7518,2401
21,SANTA MARIA,316,ALTA GRACIA,ESC NAC NORM SUP ALTA GRACIA - JOSE HERNANDEZ(B°CAMARA) 201,10,7519,7528,3430
21,SANTA MARIA,316,ALTA GRACIA,ESCUELA SAN MARTIN - URUGUAY(B°NORTE) 200,9,7529,7537,3087
21,SANTA MARIA,316,ALTA GRACIA,ESC REPUBLICA ITALIANA - COLEGIO 127 LALAHENES,8,7538,7545,2744
21,SANTA MARIA,316,ALTA GRACIA,I.P.E.M. N° 298 - RAFAEL LOZADA(B°CENTRO) 53,14,7546,7559,4802
21,SANTA MARIA,316,ALTA GRACIA,ESCUELA CURA ELEODORO FIERRO - RAMON J CARCANO(B°GOB A SABATTINI) 135,13,7560,7572,4459
21,SANTA MARIA,316,ALTA GRACIA,ESCUELA JOSE MARIA PAZ - LOS ANDES(B°CAMARA) 80,9,7573,7581,3087
21,SANTA MARIA,316,ALTA GRACIA,ESCUELA MANUEL SOLARES - ESPAÑA (B°SUR) 26,8,7582,7589,2744
21,SANTA MARIA,316,ALTA GRACIA,ESC SANTIAGO DE LINIERS - B°LINIERS,8,7590,7597,2744
21,SANTA MARIA,316A,ANIZACATE,IPEM N° 118-JUANA AZURDUY - SALOMON PALACIOS,6,7598,7603,2022
21,SANTA MARIA,316A,ANIZACATE,ESC VICENTE LOPEZ Y PLANES - ANIZACATE,6,7604,7609,2021
21,SANTA MARIA,316B,LA PAISANITA,ESC PROV DOMINGO F SARMIENTO - PUBLICA S/N,1,7610,7610,165
21,SANTA MARIA,316C,LA RANCHERITA,LOCAL COMUNAL - LA RANCHERITA,1,7611,7611,159
21,SANTA MARIA,316D,LA SERRANITA,ESC GENERAL MANUEL BELGRANO - LA SERRANITA,2,7612,7613,427
21,SANTA MARIA,316E,LOS CEDROS,ESC PROV CATALINA E DE BARON - ANICETO GRANADO S/N,4,7614,7617,1136
21,SANTA MARIA,316F,VALLE DE ANIZACATE,IPET N°118 AZURDUY (CIRC 316A) - SALOMON PALACIOS S/N,3,7618,7620,793
21,SANTA MARIA,316G,VILLA EL PRADO,ESC.PROV.J.HERNANDEZ - CALLE 10 ESQ AV N 5,4,7621,7624,1365
21,SANTA MARIA,316H,VILLA LA BOLSA,LOCAL COMUNAL - VILLA LA BOLSA,3,7625,7627,974
21,SANTA MARIA,316I,VILLA LOS AROMOS,ESC PROV DOMINGO F SARMIENTO - VILLA LOS AROMOS,3,7628,7630,850
21,SANTA MARIA,316J,VILLA PARQUE SANTA ANA,IPET 334 - AV RIVADARIA S/N,8,7631,7638,2572
21,SANTA MARIA,317,BAJO CHICO,ESC PROV B DE MONTEAGUDO - CALLE PUBLICA P/ANIZACATE,1,7639,7639,298
21,SANTA MARIA,318,RAFAEL GARCIA,ESC.PROV.FRENCH Y BERUTTI - SARMIENTO Y BERUTTI(RAFAEL GARCIA),2,7640,7641,648
21,SANTA MARIA,319,BOUWER,ESC DR FLORENTINO F BUSTOS - LIBERTADOR SAN MARTIN,5,7642,7646,1553
21,SANTA MARIA,320,BUENA VISTA,OLEGARIO V ANDRADE (CIRC 322) - PUBLICA S/N -COSME NORTE,1,7647,7647,27
21,SANTA MARIA,322,COSME,ESC PROV OLEGARIO V ANDRADE - PUBLICA S/N,1,7648,7648,50
21,SANTA MARIA,323,DESPEÑADEROS,INSTITUTO PRIVADO PIO XII - PADRE BUTELER 229,10,7649,7658,3300
21,SANTA MARIA,323,DESPEÑADEROS,ESC PROV 25 DE MAYO - CONGRESO 235,7,7659,7665,2304
21,SANTA MARIA,324,FALDA DEL CARMEN,ESC PROV DOMINGO F SARMIENTO - PUBLICA S/N,4,7666,7669,1266
21,SANTA MARIA,325,LOZADA,ESC.PROV.B.RIVADAVIA - SARMIENTO 441,5,7670,7674,1414
21,SANTA MARIA,326,MALAGUEÑO,ESC PROV MANUEL BELGRANO - GRAL BUSTOS 700,12,7675,7686,3984
21,SANTA MARIA,326,MALAGUEÑO,I.P.E.M.67-L.PIEDRABUENA - MALAGUEÑO,9,7687,7695,2988
21,SANTA MARIA,326A,YOCSINA,COLEGIO JUAN XXIII - BRIGADIER SAN MARTIN 231,6,7696,7701,1976
21,SANTA MARIA,326A,YOCSINA,ESC PROV GABRIELA MISTRAL - MARCELO GARLOT,2,7702,7703,658
21,SANTA MARIA,326B,BARRIO PRIMERO DE MAYO,ESC PROV FRAY J S MARIA DE ORO - CRUCERO GENERAL BELGRANO S/N,4,7704,7707,1348
21,SANTA MARIA,326C,SAN NICOLAS,ESC MARTIN M DE GUEMES - A CASTELLANO,6,7708,7713,1744
21,SANTA MARIA,327,MONTE RALO,ESC.DELL'ARMELLINA - ITALIA,2,7714,7715,488
21,SANTA MARIA,328,POTRERO DE GARAY,ESC IPEM 32-EST POT DE GARAY - LAS MONJITAS S/N,4,7716,7719,1241
21,SANTA MARIA,328B,VILLA CIUDAD DE AMERICA,ESC.PROV.J.V.GONZALEZ - RUTA N 5 KM 54,3,7720,7722,744
21,SANTA MARIA,329,SAN CLEMENTE,ESC.PROV.J.B.CABRAL - PUBLICA,1,7723,7723,185
21,SANTA MARIA,330,SAN ISIDRO,ESC.PROV.M.MORENO - PUBLICA,2,7724,7725,623
21,SANTA MARIA,330A,JOSE DE LA QUINTANA,ESCUELA DE MINERIA - JOSE DE LA QUINTANA,2,7726,7727,514
21,SANTA MARIA,331,TOLEDO,ESC PROV JUAN B ALBERDI - TOLEDO,7,7728,7734,2317
21,SANTA MARIA,331,TOLEDO,IPEM 107 REINO DE ESPAÑA - TOLEDO,6,7735,7740,1982
22,SOBREMONTE,332,POZO NUEVO,ESC.PROV.FCO.PASCACIO MORENO - POZO NUEVO,2,7741,7742,561
22,SOBREMONTE,333,CAMINIAGA,ESC V LOPEZ Y PLANES - CAMINIAGA,2,7743,7744,453
22,SOBREMONTE,334,CHUÑAHUASI,ESC PROV MARIANO MORENO - PUBLICA S/N,1,7745,7745,344
22,SOBREMONTE,335,CHAÑAR,I.P.E.T. N°17 - CHAÑAR,8,7746,7753,2548
23,TERCERO ARRIBA,336,ALMAFUERTE,COL NAC JOSE M ESTRADA - URUGUAY 55,13,7754,7766,4485
23,TERCERO ARRIBA,336,ALMAFUERTE,ESC REMEDIOS E DE SAN MARTIN - CASTELLI 590,11,7767,7777,3786
23,TERCERO ARRIBA,336,ALMAFUERTE,IPEM N° 299-DR S E NAUMCHIK - SANTIAGO DEL ESTERO ESQ.FRAGUEIRO,6,7778,7783,2064
23,TERCERO ARRIBA,337,ASCASUBI,ESC.M.G.PONCE - DUSSAN ALACEVICH 86,7,7784,7790,2264
23,TERCERO ARRIBA,337A,CNIA ALMADA,ESC PROV JUAN B ALBERDI - SANTA ROSA 171,2,7791,7792,565
23,TERCERO ARRIBA,338,CORRALITO,ESC PROV GRAL J DE SAN MARTIN - PABLO A PIZZURNO 149,5,7793,7797,1673
23,TERCERO ARRIBA,339,DALMACIO VELEZ,ESC PROV FRAY LUIS BELTRAN - JUANA AZURDUY 283,5,7798,7802,1407
23,TERCERO ARRIBA,340,HERNANDO,ESC GOB J F JAVIER DIAZ - HERNANDO,7,7803,7809,2387
23,TERCERO ARRIBA,340,HERNANDO,COLEGIO DIVINO CORAZON - 25 DE MAYO 100,5,7810,7814,1705
23,TERCERO ARRIBA,340,HERNANDO,ESC PABLO A PIZZURNO - HERNANDO,9,7815,7823,3069
23,TERCERO ARRIBA,340,HERNANDO,ESC LA STMA TRINIDAD - COLON 102,8,7824,7831,2721
23,TERCERO ARRIBA,341,JAMES CRAIK,INST SEC JOSE M ESTRADA - JAMES CRAIK,6,7832,7837,1965
23,TERCERO ARRIBA,341,JAMES CRAIK,ESC PROV J M SALGUEIRO - JAMES CRAIK,8,7838,7845,2616
23,TERCERO ARRIBA,342,LAS PERDICES,ESC PROV DOMINGO F SARMIENTO - LAS PERDICES,6,7846,7851,1975
23,TERCERO ARRIBA,342,LAS PERDICES,ESC CNEL DOMINGO GAY - SAN LUIS Y GENERAL PAZ S/N,7,7852,7858,2303
23,TERCERO ARRIBA,343,LOS ZORROS,ESC VICENTE LOPEZ Y PLANES - SAN MARTIN 346,2,7859,7860,603
23,TERCERO ARRIBA,344,OLIVA,ESC PROV BARTOLOME MITRE - ALVEAR 320,7,7861,7867,2394
23,TERCERO ARRIBA,344,OLIVA,C0LEGIO SAGRADO CORAZON - DON BOSCO S/N,13,7868,7880,4437
23,TERCERO ARRIBA,344,OLIVA,ESCUELA NAC.DE COMERCIO - OLIVA,13,7881,7893,4433
23,TERCERO ARRIBA,345,PAMPAYASTA NORTE,ESC PROV ANTARTIDA ARGENTINA - PAMPAYASTA NORTE,2,7894,7895,425
23,TERCERO ARRIBA,346,PAMPAYASTA SUD,ESC.PROV. REYES CATOLICOS - RIVADAVIA 198,4,7896,7899,1271
23,TERCERO ARRIBA,347,PUNTA DEL AGUA,ESC.PROV.S.A.GUTIERREZ - PUBLICA,1,7900,7900,227
23,TERCERO ARRIBA,347A,LAS ISLETILLAS,ESC PROV GABRIELA MISTRAL - LAS ISLETILLAS,1,7901,7901,262
23,TERCERO ARRIBA,348,RIO TERCERO,ESC PROV MODESTO ACUÑA - AMINTA R DE HERRERA 455,12,7902,7913,4128
23,TERCERO ARRIBA,348,RIO TERCERO,E.N.E.T. N°1 - G.SAVIO Y MENDOZA,15,7914,7928,5160
23,TERCERO ARRIBA,348,RIO TERCERO,INST ALEXIS CARREL - GRAL PAZ Y ESPAÑA 390,17,7929,7945,5848
23,TERCERO ARRIBA,348,RIO TERCERO,ESC PROV R E DE SAN MARTIN - 25 DE FEBRERO 171,12,7946,7957,4128
23,TERCERO ARRIBA,348,RIO TERCERO,ESC SUP DE COMERCIO - D DE ROJAS S/N-B°LAS VILETAS,6,7958,7963,2064
23,TERCERO ARRIBA,348,RIO TERCERO,COLEGIO JESUS MARIA Y JOSE - SAN AGUSTIN 318,14,7964,7977,4816
23,TERCERO ARRIBA,348,RIO TERCERO,ESC GREGORIA I PEREZ - ANGELINA ORTIZ ESQ INDEPENDENCIA S/N,10,7978,7987,3440
23,TERCERO ARRIBA,348,RIO TERCERO,ESC JOSE M ZAPIOLA - CHACABUCO 649,13,7988,8000,4460
23,TERCERO ARRIBA,348,RIO TERCERO,ESCUELA N° 402 - I.LA CATOLICA 190,13,8001,8013,4459
23,TERCERO ARRIBA,348,RIO TERCERO,COLEGIO C SAAVEDRA LAMAS - HILARIO CUADROS Y EDMUNDO CARTOS S/N,10,8014,8023,3430
23,TERCERO ARRIBA,349,TANCACHA,ESC PROV JOSE M PAZ - BARTOLOME MITRE 451,7,8024,8030,2410
23,TERCERO ARRIBA,349,TANCACHA,ESC GRAL JOSE DE SAN MARTIN - SARMIENTO 1.076,7,8031,8037,2408
23,TERCERO ARRIBA,349A,GENERAL FOTHERINGHAM,ESC PROV GRAL BATOLOME MITRE - SAN JUAN ESQ BELGRANO,2,8038,8039,352
24,TOTORAL,350,CANDELARIA,ESC PROV GRAL ARENALES - CANDELARIA,2,8040,8041,400
24,TOTORAL,351,CAÑADA DE LUQUE,ESC.R.J.CARCANO - CAÑADA DE LUQUE,4,8042,8045,1185
24,TOTORAL,351A,LA PAMPA,ESC PROV BERNARDINO RIVADAVIA - PUBLICA S/N,3,8046,8048,718
24,TOTORAL,352,LAS PEÑAS,ESC.PROV.J.F.KENNEDY - LIDORO CENTURION 324,5,8049,8053,1673
24,TOTORAL,352A,LOS MISTOLES,ESC PROV PEDRO N ARIAS - PUBLICA S/N,1,8054,8054,144
24,TOTORAL,353,MACHA,ESC CEFERINO NAMUNCURA - MACHA,1,8055,8055,76
24,TOTORAL,354,SANTA CATALINA,ESC PROV GREGORIA MATORRAS - PUBLICA S/N,1,8056,8056,234
24,TOTORAL,355,SARMIENTO,ESC.PROV.S.MARTIN Y GOMEZ - PUBLICA,4,8057,8060,1088
24,TOTORAL,356,SIMBOLAR,ESC.PROV.F.AMEGHINO - PUBLICA,1,8061,8061,319
24,TOTORAL,357,SINSACATE,ESC.PROV.CNEL. PRINGLES - PUBLICA- CAMINO A SAN LORENZO,6,8062,8067,1774
24,TOTORAL,358,SITON,ESC.PROV.24 DE SEPTIEMBRE - 8 DE DICIEMBRE S/N,2,8068,8069,626
24,TOTORAL,359,VILLA DEL TOTORAL,ESC PROV BARTOLOME MITRE - BV.ALLENDE S/N,10,8070,8079,3375
24,TOTORAL,359,VILLA DEL TOTORAL,ESC NORM SUP V DEL TOTORAL - REP ARGENTINA Y PTE PERON S/N,6,8080,8085,2022
24,TOTORAL,359,VILLA DEL TOTORAL,IPETYM N° 74 FRAY M ESQUIU - S/C S/N,7,8086,8092,2359
25,TULUMBA,360,CHURQUI CAÑADA,ESC PROV MARIANO MORENO - PUBLICA S/N,1,8093,8093,163
25,TULUMBA,360A,EL RODEO,ESC PROV MIGUEL DE GUEMES - EL RODEO,1,8094,8094,243
25,TULUMBA,360B,LA TOMA,ESCUELA ESTEBAN ECHEVERRIA - LA TOMA,1,8095,8095,115
25,TULUMBA,361,LAS ARRIAS,ESC.J.M.ESTRADA - AV.SAN MARTIN,6,8096,8101,2046
25,TULUMBA,362,EL BAÑADO,ESC PROV 25 DE MAYO - EL BAÑADO,1,8102,8102,39
25,TULUMBA,363,ISLA DE SAN ANTONIO,ESC PROV JOSE MARMOL - CAMINO PROVINCIAL S/N,1,8103,8103,49
25,TULUMBA,364,LA DORMIDA,I.P.E.A. N°15 - 2A DORMIDA,7,8104,8110,2401
25,TULUMBA,364,LA DORMIDA,ESC.PROV.F.N.LAPRIDA - LA DORMIDA,6,8111,8116,2058
25,TULUMBA,365,LAS MASITAS,ESC LUIS E JUNCOS(EX NAC 212) - LAS MASITAS,1,8117,8117,16
25,TULUMBA,366,LUCIO V MANSILLA,ESC.MARIA L.ROBLEDO - PUBLICA,4,8118,8121,1088
25,TULUMBA,367,ROSARIO DEL SALADILLO,ESC.PROV.D.F.SARMIENTO - JAVIER GARCIA,2,8122,8123,493
25,TULUMBA,368,SAN JOSE DE LAS SALINAS,ESC.PROV.V.MERCANTE - ONCATIVO,2,8124,8125,648
25,TULUMBA,369,SAN PEDRO NORTE,ESC MANUEL BELGRANO - 9 DE JULIO S/N,2,8126,8127,587
25,TULUMBA,370,SANTA CRUZ,ESC PROV CORNELIO SAAVEDRA - PUBLICA S/N,1,8128,8128,97
25,TULUMBA,370A,LA CAÑADA,ESC PROV MANUEL DORREGO - PUBLICA S/N,1,8129,8129,28
25,TULUMBA,371,TULUMBA,ESC.PROV.OB.O.CORREA - CALLE REAL,6,8130,8135,1844
26,UNION,372,ALTO ALEGRE,ESC.PROV.DR.GARCIA GONZALEZ - JULIO A ROCA 115,4,8136,8139,1122
26,UNION,372A,ANA ZUMARAN,ESC PROV JUAN P ESNAOLA - ANA ZUMARAN,1,8140,8140,175
26,UNION,373,BALLESTEROS,ESC PROV GRAL SAN MARTIN - PTE PERON- CENTRO 75,7,8141,8147,2338
26,UNION,373,BALLESTEROS,ESC GRAL BELGRANO-IPEM N°139 - ANSELMO G VAZQUEZ-CENTRO 522,4,8148,8151,1335
26,UNION,374,BALLESTEROS SUD,ESCUELA N°9 - BALLESTEROS SUD,2,8152,8153,675
26,UNION,375,BELL VILLE,ESC.NORMAL F.ALCORTA - 25 DE MAYO 135,22,8154,8175,7568
26,UNION,375,BELL VILLE,ESC F AMEGHINO - ENTRE RIOS 457,11,8176,8186,3784
26,UNION,375,BELL VILLE,ESC.SUPERIOR DE COMERCIO - F.MOLINA 69,14,8187,8200,4816
26,UNION,375,BELL VILLE,ESCUELA A MATTERSON - PTE PERON 414,12,8201,8212,4128
26,UNION,375,BELL VILLE,ESC PONCIANO VIVANCO - AMEGHINO 155,16,8213,8228,5489
26,UNION,375,BELL VILLE,COLEGIO SAN JOSE - BV FIGUEROA ALCORTA 40,14,8229,8242,4802
26,UNION,376,BISMARCK,ESC PROV B ERNARDINO RIVADAVIA - RIVADAVIA 360,2,8243,8244,415
26,UNION,377,BREMEN,ESC PROV ALMAFUERTE - PUBLICA S/N,1,8245,8245,246
26,UNION,378,CANALS,ESC PROV J HERNANDEZ - CANALS,10,8246,8255,3353
26,UNION,378,CANALS,INSTITUTO BELISARIO ROLDAN - CANALS,13,8256,8268,4355
26,UNION,379,CARCANO,ESC.PROV.A.M.ZUMARAN D CARCANO - PUBLICA,1,8269,8269,17
26,UNION,381,CINTRA,ESC DE COM JOSE M.ESTRADA - BELGRANO 548,4,8270,8273,1350
26,UNION,382,CHILIBROSTE,ESC PROV B QUINQUELA MARTIN - SANTA FE S/N,2,8274,8275,615
26,UNION,384,PUEBLO ITALIANO,ESC.PROV.V.LOPEZ Y PLANES - BUENOS AIRES 414,5,8276,8280,1585
26,UNION,385,ESCALANTE,ESC.M.C.G.DE MATOCCIA - ITALIA 1.320,4,8281,8284,1367
26,UNION,386,GOULD,ESC R VERA PEÑALOZA - GOULD,2,8285,8286,632
26,UNION,387,IDIAZABAL,ESC P ALBARRACIN DE SARMIENTO - 9 DE JULIO 551,5,8287,8291,1470
26,UNION,389,LABORDE,ESCUELA MARIANO MORENO - LABORDE,5,8292,8296,1630
26,UNION,389,LABORDE,INST SUP DE PROFESORADO - SAN MARTIN 451,6,8297,8302,1955
26,UNION,389,LABORDE,ESCUELA PROV DARDO ROCHA - LABORDE,5,8303,8307,1625
26,UNION,390,MONTE LEÑA,ESC.PROV.D.F.SARMIENTO - CARDO 146,2,8308,8309,514
26,UNION,391,MONTE MAIZ,INSTITUTO SAGRADO CORAZON - 9 DE JULIO 2.250,13,8310,8322,4290
26,UNION,391,MONTE MAIZ,ESCUELA JOSE DE SAN MARTIN - SAN MARTIN 1.518,7,8323,8329,2310
26,UNION,392,MORRISON,ESC PROV NIÑAS DE AYOHUMA - VICENTE LOPEZ Y PLANES S/N,4,8330,8333,1328
26,UNION,392,MORRISON,ESC PROV LEOPOLDO LUGONES - MORRISON,6,8334,8339,1989
26,UNION,393,NOETINGER,ESC PROV R E DE SAN MARTIN - NOETINGER,6,8340,8345,1956
26,UNION,393,NOETINGER,ESCUELA LEANDRO N ALEM - NOETINGER,8,8346,8353,2602
26,UNION,394,ORDOÑEZ,ESCUELA AMADEO AUCHTER - CALLE 10 N°119,7,8354,8360,2356
26,UNION,395,PASCANAS,INST GALA ORTIZ FERNANDEZ - ESPAÑA 16,5,8361,8365,1547
26,UNION,395,PASCANAS,ESC MAESTRO J RECALDE - PASCANAS,3,8366,8368,927
26,UNION,396,POSSE,INST DALMACIO VELEZ SARSFIELD - BELGRANO 222,12,8369,8380,4093
26,UNION,396,POSSE,ESC PROV JUANA MANSO - DEAN FUNES 346,5,8381,8385,1705
26,UNION,396,POSSE,INSTITUTO SAN JOSE - 9 DE JULIO Y COLON,5,8386,8390,1705
26,UNION,396A,VILLA LOS PATOS,ESC.PROV.M.SASTRE - PUBLICA,1,8391,8391,43
26,UNION,397,SAN ANTONIO,ESC.PROV.P.PIZZURNO - MAESTRO FERNANDEZ 538,5,8392,8396,1446
26,UNION,397A,CORRAL DEL BAJO,ESCUELA VALENTIN ALSINA - CORRAL DEL BAJO,1,8397,8397,13
26,UNION,400,SAN MARCOS SUD,INST JOSE DE SAN MARTIN - SAN MARCOS SUD,4,8398,8401,1380
26,UNION,400,SAN MARCOS SUD,ESC PROV M BUCHARDO - SAN MARCOS SUD,4,8402,8405,1377
26,UNION,401,SANTA MARIA,ESC PROV PAULA ALBARRACIN - PUBLICA S/N,1,8406,8406,204
26,UNION,402,VIAMONTE,INSTITUTO JUAN B ALBERDI - AVELLANEDA 182,5,8407,8411,1574
